"mixedUseAssessmentKey","provalLrsnId","realEstatePropertyCode","assessmentChangeReasonTypeDsc","mixedUseAssessmentDate","commercialLandAmt","commercialImprovementAmt","totalCommercialAmt","residentialLandAmt","residentialImprovementAmt","totalResidentialAmt"
"1","8773","05031006","","2012-01-01T00:00:00","123000","231900","354900","273900","291600","565500"
"2","8773","05031006","","2011-01-01T00:00:00","123000","203600","326600","273900","250000","523900"
"3","8773","05031006","","2010-01-01T00:00:00","123000","186800","309800","273900","193400","467300"
"4","8773","05031006","","2009-01-01T00:00:00","156800","181100","337900","349100","204700","553800"
"5","8773","05031006","","2008-01-01T00:00:00","156800","193200","350000","349100","160700","509800"
"6","8773","05031006","01- Annual","2013-01-01T00:00:00","123000","238000","361000","273900","286900","560800"
"7","8773","05031006","01- Annual","2014-01-01T00:00:00","123000","254900","377900","273900","504300","778200"
"8","8773","05031006","01- Annual","2015-01-01T00:00:00","396900","-19000","377900","0","792300","792300"
"9","8862","05038013","01- Annual","2015-01-01T00:00:00","383400","-217600","165800","0","621600","621600"
"10","8862","05038013","01- Annual","2014-01-01T00:00:00","73900","91900","165800","280500","213100","493600"
"11","8862","05038013","01- Annual","2013-01-01T00:00:00","73900","85100","159000","280500","169500","450000"
"12","8862","05038013","","2008-01-01T00:00:00","87000","66500","153500","210400","139100","349500"
"13","8862","05038013","","2009-01-01T00:00:00","87000","98300","185300","280500","106400","386900"
"14","8862","05038013","","2010-01-01T00:00:00","73900","84200","158100","280500","33900","314400"
"15","8862","05038013","","2011-01-01T00:00:00","73900","88900","162800","280500","64000","344500"
"16","8862","05038013","","2012-01-01T00:00:00","73900","85100","159000","280500","96500","377000"
"17","9321","05056002","","2012-01-01T00:00:00","488900","0","488900","2940000","0","2940000"
"18","9321","05056002","","2011-01-01T00:00:00","449700","0","449700","2695000","1000","2696000"
"19","9321","05056002","","2010-01-01T00:00:00","469300","0","469300","2744000","1000","2745000"
"20","9321","05056002","","2009-01-01T00:00:00","586600","0","586600","3234000","1000","3235000"
"21","9321","05056002","","2008-01-01T00:00:00","586600","0","586600","3234000","1000","3235000"
"22","9712","06002031","","2008-01-01T00:00:00","156500","213900","370400","66000","40800","106800"
"23","9712","06002031","","2009-01-01T00:00:00","156500","219000","375500","66000","44800","110800"
"24","9712","06002031","01- Annual","2013-01-01T00:00:00","166500","215600","382100","56000","56200","112200"
"25","9712","06002031","","2010-01-01T00:00:00","166500","153800","320300","56000","37500","93500"
"26","9712","06002031","","2011-01-01T00:00:00","166500","163500","330000","56000","55900","111900"
"27","9712","06002031","","2012-01-01T00:00:00","166500","192800","359300","56000","65400","121400"
"28","9712","06002031","01- Annual","2014-01-01T00:00:00","166500","233400","399900","56000","99600","155600"
"29","9712","06002031","01- Annual","2015-01-01T00:00:00","222500","177400","399900","0","158500","158500"
"30","10406","06028015","01- Annual","2015-01-01T00:00:00","207100","141500","348600","0","316900","316900"
"31","10406","06028015","01- Annual","2014-01-01T00:00:00","74500","274100","348600","132000","185500","317500"
"32","10406","06028015","","2012-01-01T00:00:00","74500","245800","320300","132000","105800","237800"
"33","10406","06028015","","2011-01-01T00:00:00","74500","233700","308200","132000","91900","223900"
"34","10406","06028015","","2010-01-01T00:00:00","74500","224600","299100","132000","67500","199500"
"35","10406","06028015","01- Annual","2013-01-01T00:00:00","74500","258500","333000","132000","96800","228800"
"36","10406","06028015","","2009-01-01T00:00:00","74500","276200","350700","132000","104400","236400"
"37","10406","06028015","","2008-01-01T00:00:00","108400","234700","343100","132000","86100","218100"
"38","10855","07006012","","2008-01-01T00:00:00","583900","420100","1004000","132000","217500","349500"
"39","10855","07006012","","2009-01-01T00:00:00","451900","571400","1023300","264000","108600","372600"
"40","10855","07006012","01- Annual","2013-01-01T00:00:00","495900","643400","1139300","220000","192800","412800"
"41","10855","07006012","","2010-01-01T00:00:00","491900","472800","964700","224000","90400","314400"
"42","10855","07006012","","2011-01-01T00:00:00","495900","498000","993900","220000","132500","352500"
"43","10855","07006012","","2012-01-01T00:00:00","495900","635600","1131500","220000","184800","404800"
"44","10855","07006012","01- Annual","2014-01-01T00:00:00","495900","684500","1180400","220000","352800","572800"
"45","10855","07006012","01- Annual","2015-01-01T00:00:00","715900","464500","1180400","0","633800","633800"
"46","10859","07006016","01- Annual","2015-01-01T00:00:00","52500","221100","273600","401600","875300","1276900"
"47","10859","07006016","01- Annual","2016-01-01T00:00:00","52500","246300","298800","421400","1399800","1821200"
"48","10859","07006016","01- Annual","2014-01-01T00:00:00","8400","240500","248900","363100","845900","1209000"
"49","10859","07006016","","2012-01-01T00:00:00","52500","188600","241100","363100","829000","1192100"
"50","10859","07006016","","2011-01-01T00:00:00","48300","192800","241100","367300","777200","1144500"
"51","10859","07006016","","2010-01-01T00:00:00","50400","171400","221800","365200","687600","1052800"
"52","10859","07006016","01- Annual","2013-01-01T00:00:00","52500","191100","243600","363100","841700","1204800"
"53","10859","07006016","","2009-01-01T00:00:00","63000","187100","250100","488900","591700","1080600"
"54","10859","07006016","","2008-01-01T00:00:00","63000","208400","271400","488900","683500","1172400"
"55","11215","07007037","","2008-01-01T00:00:00","142500","299500","442000","519300","473200","992500"
"56","11215","07007037","","2009-01-01T00:00:00","142500","234500","377000","519300","327200","846500"
"57","11215","07007037","01- Annual","2013-01-01T00:00:00","118800","292000","410800","322600","700000","1022600"
"58","11215","07007037","","2010-01-01T00:00:00","114000","233700","347700","327400","515900","843300"
"59","11215","07007037","","2011-01-01T00:00:00","109300","267800","377100","332100","582400","914500"
"60","11215","07007037","","2012-01-01T00:00:00","118800","287700","406500","322600","704400","1027000"
"61","11215","07007037","01- Annual","2014-01-01T00:00:00","40300","384000","424300","322600","703400","1026000"
"62","11215","07007037","01- Annual","2016-01-01T00:00:00","118800","285300","404100","377600","575300","952900"
"63","11215","07007037","01- Annual","2015-01-01T00:00:00","118800","355400","474200","356600","745000","1101600"
"64","11406","07012015","01- Annual","2015-01-01T00:00:00","486500","-33100","453400","0","316900","316900"
"65","11406","07012015","01- Annual","2014-01-01T00:00:00","366500","86900","453400","120000","191300","311300"
"66","11406","07012015","","2012-01-01T00:00:00","366500","60200","426700","120000","102600","222600"
"67","11406","07012015","","2011-01-01T00:00:00","376500","24400","400900","110000","99600","209600"
"68","11406","07012015","","2010-01-01T00:00:00","374500","3800","378300","112000","84400","196400"
"69","11406","07012015","01- Annual","2013-01-01T00:00:00","366500","66700","433200","120000","104300","224300"
"70","11406","07012015","","2009-01-01T00:00:00","354500","17200","371700","132000","100800","232800"
"71","11406","07012015","","2008-01-01T00:00:00","354500","13000","367500","132000","81600","213600"
"72","15138","10028012","","2008-01-01T00:00:00","104000","619300","723300","396000","12900","408900"
"73","15138","10028012","","2009-01-01T00:00:00","104000","594400","698400","396000","28000","424000"
"74","15138","10028012","01- Annual","2013-01-01T00:00:00","140000","647800","787800","360000","182000","542000"
"75","15138","10028012","","2010-01-01T00:00:00","164000","484200","648200","336000","21800","357800"
"76","15138","10028012","","2011-01-01T00:00:00","170000","534800","704800","330000","28600","358600"
"77","15138","10028012","","2012-01-01T00:00:00","140000","647800","787800","360000","100400","460400"
"78","15138","10028012","01- Annual","2014-01-01T00:00:00","140000","647800","787800","360000","299900","659900"
"79","15138","10028012","01- Annual","2015-01-01T00:00:00","500000","345200","845200","0","911100","911100"
"80","15235","10035023","","2012-01-01T00:00:00","1102000","117400","1219400","198000","120700","318700"
"81","15235","10035023","","2011-01-01T00:00:00","1102000","43500","1145500","198000","87800","285800"
"82","15235","10035023","","2010-01-01T00:00:00","1102000","13200","1115200","198000","62200","260200"
"83","15235","10035023","01- Annual","2013-01-01T00:00:00","1102000","134200","1236200","198000","118300","316300"
"84","15235","10035023","","2009-01-01T00:00:00","1102000","122000","1224000","198000","110400","308400"
"85","15235","10035023","","2008-01-01T00:00:00","1102000","108100","1210100","198000","77100","275100"
"86","16193","11012005","","2008-01-01T00:00:00","30300","0","30300","1097900","0","1097900"
"87","16194","11012006","","2008-01-01T00:00:00","36200","0","36200","1313800","0","1313800"
"88","16195","11012008","","2008-01-01T00:00:00","37800","0","37800","1371400","0","1371400"
"89","16196","11012009","","2008-01-01T00:00:00","34100","0","34100","1235700","0","1235700"
"90","16197","11012010","","2008-01-01T00:00:00","18800","0","18800","680300","0","680300"
"91","16206","11012020","","2008-01-01T00:00:00","58500","0","58500","2122700","0","2122700"
"92","16207","11012021","","2008-01-01T00:00:00","56000","0","56000","2029900","0","2029900"
"93","16210","11012025","","2008-01-01T00:00:00","67000","0","67000","2428600","0","2428600"
"94","16211","11012026","","2008-01-01T00:00:00","50800","0","50800","1843700","0","1843700"
"95","19075","13018009","01- Annual","2018-01-01T00:00:00","106500","36900","143400","6103300","1623900","7727200"
"96","19076","13018012","01- Annual","2018-01-01T00:00:00","10700","29600","40300","612400","1299100","1911500"
"97","19077","13018013","01- Annual","2018-01-01T00:00:00","45000","29600","74600","2580300","1299100","3879400"
"98","19078","13018014","01- Annual","2018-01-01T00:00:00","54000","29600","83600","3093300","1299100","4392400"
"99","19079","13018016","01- Annual","2018-01-01T00:00:00","34300","29600","63900","1965400","1299100","3264500"
"100","19080","13018017","01- Annual","2018-01-01T00:00:00","9100","29600","38700","523300","1299100","1822400"
"101","19601","13031015","","2008-01-01T00:00:00","171500","232200","403700","66000","18300","84300"
"102","19601","13031015","","2009-01-01T00:00:00","171500","101300","272800","66000","462600","528600"
"103","19601","13031015","01- Annual","2013-01-01T00:00:00","177500","237800","415300","60000","476900","536900"
"104","19601","13031015","","2010-01-01T00:00:00","181500","84400","265900","56000","390000","446000"
"105","19601","13031015","","2011-01-01T00:00:00","182500","84900","267400","55000","445100","500100"
"106","19601","13031015","","2012-01-01T00:00:00","177500","125000","302500","60000","496500","556500"
"107","21915","14022010","","2012-01-01T00:00:00","124600","179700","304300","180000","133700","313700"
"108","21915","14022010","","2011-01-01T00:00:00","139600","146300","285900","165000","101700","266700"
"109","21915","14022010","","2010-01-01T00:00:00","136600","135300","271900","168000","74800","242800"
"110","21915","14022010","01- Annual","2013-01-01T00:00:00","124600","209100","333700","180000","106200","286200"
"111","21915","14022010","","2009-12-01T00:00:00","106600","183200","289800","198000","89800","287800"
"112","21915","14022010","","2009-01-01T00:00:00","238600","500800","739400","66000","36800","102800"
"113","21915","14022010","","2008-01-01T00:00:00","238600","136500","375100","66000","28200","94200"
"114","21915","14022010","01- Annual","2014-01-01T00:00:00","174000","247300","421300","174100","44400","218500"
"115","21915","14022010","01- Annual","2015-01-01T00:00:00","348100","73200","421300","0","298600","298600"
"116","22480","14032001","01- Annual","2017-01-01T00:00:00","142200","534100","676300","9129900","33230700","42360600"
"117","22481","14032002","01- Annual","2017-01-01T00:00:00","23900","0","23900","1534000","5582700","7116700"
"118","22482","14032003","01- Annual","2017-01-01T00:00:00","87500","0","87500","5615000","20439400","26054400"
"119","22483","14032004","01- Annual","2017-01-01T00:00:00","101400","593600","695000","6511100","23699500","30210600"
"120","22506","14035001","01- Annual","2013-01-01T00:00:00","55000","0","55000","2674500","0","2674500"
"121","22507","14035002","01- Annual","2013-01-01T00:00:00","41200","0","41200","2004100","0","2004100"
"122","22508","14035003","01- Annual","2013-01-01T00:00:00","41200","0","41200","2004100","0","2004100"
"123","22510","14035005","01- Annual","2013-01-01T00:00:00","61900","0","61900","3006100","0","3006100"
"124","22511","14035006","01- Annual","2013-01-01T00:00:00","51600","0","51600","2505100","0","2505100"
"125","22512","14035008","01- Annual","2013-01-01T00:00:00","82500","0","82500","4008200","0","4008200"
"126","22513","14035010","01- Annual","2013-01-01T00:00:00","41200","0","41200","2004100","0","2004100"
"127","22514","14035011","01- Annual","2013-01-01T00:00:00","41200","0","41200","2004100","0","2004100"
"128","22516","14035013","01- Annual","2013-01-01T00:00:00","41200","0","41200","2004100","0","2004100"
"129","22517","14035014","01- Annual","2013-01-01T00:00:00","41200","0","41200","2004100","0","2004100"
"130","22518","14035015","01- Annual","2013-01-01T00:00:00","41200","0","41200","2004100","0","2004100"
"131","22519","14035016","01- Annual","2013-01-01T00:00:00","44200","0","44200","2146400","0","2146400"
"132","22520","14035018","01- Annual","2013-01-01T00:00:00","12900","0","12900","626300","0","626300"
"133","22521","14035019","01- Annual","2013-01-01T00:00:00","12900","0","12900","626300","0","626300"
"134","22522","14035020","01- Annual","2013-01-01T00:00:00","12900","0","12900","626300","0","626300"
"135","22523","14035021","01- Annual","2013-01-01T00:00:00","12900","0","12900","626300","0","626300"
"137","23311","14042574","01- Annual","2017-01-01T00:00:00","287700","2261800","2549500","32938000","112999200","145937200"
"138","23311","14042574","01- Annual","2016-01-01T00:00:00","287700","2219100","2506800","31023000","119753600","150776600"
"139","23311","14042574","03- Board of Equalization","2015-11-03T00:00:00","287700","2186700","2474400","29491000","119712500","149203500"
"140","23311","14042574","01- Annual","2015-01-01T00:00:00","287700","2218100","2505800","29491000","124247100","153738100"
"141","23311","14042574","03- Board of Equalization","2014-09-09T00:00:00","287700","1889100","2176800","26810000","126024000","152834000"
"142","23311","14042574","01- Annual","2014-01-01T00:00:00","287700","1935900","2223600","26810000","130922900","157732900"
"143","23311","14042574","03- Board of Equalization","2016-09-30T00:00:00","287700","2219100","2506800","31023000","113668800","144691800"
"144","23311","14042574","01- Annual","2018-01-01T00:00:00","287700","1921800","2209500","32938000","111902800","144840800"
"145","23311","14042574","01- Annual","2013-01-01T00:00:00","287700","1786100","2073800","26810000","116931100","143741100"
"146","23311","14042574","","2008-01-01T00:00:00","287700","1511600","1799300","25278000","93891000","119169000"
"147","23311","14042574","","2009-01-01T00:00:00","287700","1439700","1727400","25278000","81508800","106786800"
"148","23311","14042574","","2010-01-01T00:00:00","230200","1569100","1799300","21448000","85602800","107050800"
"149","23311","14042574","","2011-01-01T00:00:00","263700","1640900","1904600","22980000","91550300","114530300"
"150","23311","14042574","","2012-01-01T00:00:00","287700","1666000","1953700","26810000","105883200","132693200"
"151","23343","14045008","","2012-01-01T00:00:00","1611700","8427600","10039300","35630000","128250900","163880900"
"152","23343","14045008","","2011-01-01T00:00:00","1477400","6681500","8158900","27995000","102096000","130091000"
"153","23343","14045008","","2010-01-01T00:00:00","1289300","6493700","7783000","28504000","91856700","120360700"
"154","23343","14045008","","2012-10-01T00:00:00","1611700","8446100","10057800","35630000","117263600","152893600"
"155","23343","14045008","","2010-10-01T00:00:00","1289300","6234700","7524000","28504000","88194800","116698800"
"156","23343","14045008","","2009-10-01T00:00:00","1611700","7354300","8966000","33594000","104160200","137754200"
"157","23343","14045008","","2009-01-01T00:00:00","1611700","7354300","8966000","33594000","114854700","148448700"
"158","23343","14045008","","2008-01-01T00:00:00","1611700","7468400","9080100","33594000","96140900","129734900"
"159","23343","14045008","01- Annual","2013-01-01T00:00:00","1611700","8427600","10039300","35630000","128250900","163880900"
"160","23343","14045008","01- Annual","2013-01-01T00:00:00","1611700","8427600","10039300","35630000","128250900","163880900"
"161","23343","14045008","01- Annual","2018-01-01T00:00:00","1611700","7637500","9249200","43774000","123264200","167038200"
"162","23343","14045008","03- Board of Equalization","2017-08-31T00:00:00","1611700","7547400","9159100","43774000","112848800","156622800"
"163","23343","14045008","03- Board of Equalization","2016-09-06T00:00:00","1611700","7938800","9550500","41229000","106429900","147658900"
"164","23343","14045008","01- Annual","2014-01-01T00:00:00","1611700","9546700","11158400","35630000","137308900","172938900"
"165","23343","14045008","03- Board of Equalization","2014-08-29T00:00:00","1611700","9546700","11158400","35630000","121967900","157597900"
"166","23343","14045008","01- Annual","2015-01-01T00:00:00","1611700","9397900","11009600","39193000","134474900","173667900"
"167","23343","14045008","01- Annual","2016-01-01T00:00:00","1611700","8256800","9868500","41229000","121990500","163219500"
"168","23343","14045008","03- Board of Equalization","2015-07-20T00:00:00","1649600","7682600","9332200","39193000","116757800","155950800"
"169","23343","14045008","01- Annual","2017-01-01T00:00:00","1611700","7657400","9269100","43774000","114729900","158503900"
"170","23344","14046006","01- Annual","2016-01-01T00:00:00","18700","0","18700","2818400","0","2818400"
"171","23344","14046006","01- Annual","2015-01-01T00:00:00","18700","0","18700","2679200","0","2679200"
"172","23344","14046006","01- Annual","2014-01-01T00:00:00","18700","0","18700","2435700","0","2435700"
"173","23344","14046006","01- Annual","2017-01-01T00:00:00","18700","0","18700","2992400","0","2992400"
"174","23344","14046006","01- Annual","2018-01-01T00:00:00","18700","0","18700","2992400","0","2992400"
"175","23344","14046006","01- Annual","2013-01-01T00:00:00","18700","0","18700","2435700","0","2435700"
"176","23344","14046006","","2008-01-01T00:00:00","18700","0","18700","2296500","0","2296500"
"177","23344","14046006","","2009-01-01T00:00:00","18700","0","18700","2296500","0","2296500"
"178","23344","14046006","","2010-01-01T00:00:00","14900","0","14900","1948500","0","1948500"
"179","23344","14046006","","2011-01-01T00:00:00","17100","0","17100","2087700","0","2087700"
"180","23344","14046006","","2012-01-01T00:00:00","18700","0","18700","2435700","0","2435700"
"181","23348","14046026","","2012-01-01T00:00:00","1400","0","1400","187800","0","187800"
"182","23348","14046026","","2011-01-01T00:00:00","1300","0","1300","161000","0","161000"
"183","23348","14046026","","2010-01-01T00:00:00","1200","0","1200","150300","0","150300"
"184","23348","14046026","","2009-01-01T00:00:00","1400","0","1400","177100","0","177100"
"185","23348","14046026","","2008-01-01T00:00:00","1400","0","1400","177100","0","177100"
"186","23348","14046026","01- Annual","2013-01-01T00:00:00","1400","0","1400","187800","0","187800"
"187","23348","14046026","01- Annual","2018-01-01T00:00:00","1400","0","1400","230800","0","230800"
"188","23348","14046026","01- Annual","2017-01-01T00:00:00","1400","0","1400","230800","0","230800"
"189","23348","14046026","01- Annual","2014-01-01T00:00:00","1400","0","1400","187800","0","187800"
"190","23348","14046026","01- Annual","2015-01-01T00:00:00","1400","0","1400","206600","0","206600"
"191","23348","14046026","01- Annual","2016-01-01T00:00:00","1400","0","1400","217400","0","217400"
"192","23349","14046027","01- Annual","2016-01-01T00:00:00","8000","0","8000","1204900","0","1204900"
"193","23349","14046027","01- Annual","2015-01-01T00:00:00","8000","0","8000","1145400","0","1145400"
"194","23349","14046027","01- Annual","2014-01-01T00:00:00","8000","0","8000","1041300","0","1041300"
"195","23349","14046027","01- Annual","2017-01-01T00:00:00","8000","0","8000","1279300","0","1279300"
"196","23349","14046027","01- Annual","2018-01-01T00:00:00","8000","0","8000","1279300","0","1279300"
"197","23349","14046027","01- Annual","2013-01-01T00:00:00","8000","0","8000","1041300","0","1041300"
"198","23349","14046027","","2008-01-01T00:00:00","8000","0","8000","981800","0","981800"
"199","23349","14046027","","2009-01-01T00:00:00","8000","0","8000","981800","0","981800"
"200","23349","14046027","","2010-01-01T00:00:00","6400","0","6400","833000","0","833000"
"201","23349","14046027","","2011-01-01T00:00:00","7300","0","7300","892500","0","892500"
"202","23349","14046027","","2012-01-01T00:00:00","8000","0","8000","1041300","0","1041300"
"203","23350","14046028","","2012-01-01T00:00:00","9300","0","9300","1217800","0","1217800"
"204","23350","14046028","","2011-01-01T00:00:00","8600","0","8600","1043900","0","1043900"
"205","23350","14046028","","2010-01-01T00:00:00","7500","0","7500","974300","0","974300"
"206","23350","14046028","","2009-01-01T00:00:00","9300","0","9300","1148200","0","1148200"
"207","23350","14046028","","2008-01-01T00:00:00","9300","0","9300","1148200","0","1148200"
"208","23350","14046028","01- Annual","2013-01-01T00:00:00","9300","0","9300","1217800","0","1217800"
"209","23350","14046028","01- Annual","2018-01-01T00:00:00","9300","0","9300","1496200","0","1496200"
"210","23350","14046028","01- Annual","2017-01-01T00:00:00","9300","0","9300","1496200","0","1496200"
"211","23350","14046028","01- Annual","2014-01-01T00:00:00","9300","0","9300","1217800","0","1217800"
"212","23350","14046028","01- Annual","2015-01-01T00:00:00","9300","0","9300","1339600","0","1339600"
"213","23350","14046028","01- Annual","2016-01-01T00:00:00","9300","0","9300","1409200","0","1409200"
"214","23351","14046029","01- Annual","2016-01-01T00:00:00","155800","1290800","1446600","23510100","90163000","113673100"
"215","23351","14046029","01- Annual","2015-01-01T00:00:00","155800","1271600","1427400","22349100","89113900","111463000"
"216","23351","14046029","03- Board of Equalization","2014-10-06T00:00:00","155800","1015200","1171000","20317400","67225500","87542900"
"217","23351","14046029","01- Annual","2014-01-01T00:00:00","155800","1278200","1434000","20317400","95657000","115974400"
"218","23351","14046029","01- Annual","2017-01-01T00:00:00","155800","1306900","1462700","24961300","91482100","116443400"
"219","23351","14046029","01- Annual","2018-01-01T00:00:00","155800","897200","1053000","24961300","92100500","117061800"
"220","23351","14046029","03- Board of Equalization","2017-10-24T00:00:00","155800","919500","1075300","24961300","88328700","113290000"
"221","23351","14046029","03- Board of Equalization","2013-08-12T00:00:00","155800","1099700","1255500","20317400","95093800","115411200"
"222","23351","14046029","","2009-09-01T00:00:00","155800","971200","1127000","19156400","77861500","97017900"
"223","23351","14046029","01- Annual","2013-01-01T00:00:00","155800","1170100","1325900","20317400","97428600","117746000"
"224","23351","14046029","","2008-01-01T00:00:00","155800","1004100","1159900","19156400","76005800","95162200"
"225","23351","14046029","","2009-01-01T00:00:00","155800","971200","1127000","19156400","75958400","95114800"
"226","23351","14046029","","2010-01-01T00:00:00","124600","920800","1045400","16253900","70169800","86423700"
"227","23351","14046029","","2011-01-01T00:00:00","142800","1016100","1158900","17414900","76342600","93757500"
"228","23351","14046029","","2012-01-01T00:00:00","155800","1087200","1243000","20317400","85940900","106258300"
"229","23353","14047019","","2012-01-01T00:00:00","339600","4048800","4388400","23348600","179595400","202944000"
"230","23353","14047019","","2011-01-01T00:00:00","311300","3671500","3982800","20013100","158549400","178562500"
"231","23353","14047019","","2010-01-01T00:00:00","271700","3464600","3736300","18678800","129817800","148496600"
"232","23353","14047019","","2009-01-01T00:00:00","339600","3869400","4209000","22014400","145767500","167781900"
"233","23353","14047019","","2008-01-01T00:00:00","339600","4060900","4400500","22014400","151153100","173167500"
"234","23353","14047019","01- Annual","2013-01-01T00:00:00","339600","4161800","4501400","23348600","186308100","209656700"
"235","23353","14047019","01- Annual","2018-01-01T00:00:00","339600","0","339600","28685400","0","28685400"
"236","23353","14047019","03- Board of Equalization","2016-09-30T00:00:00","339600","6688000","7027600","27017600","199063000","226080600"
"237","23353","14047019","01- Annual","2017-01-01T00:00:00","339600","5589500","5929100","28685400","192111700","220797100"
"238","23353","14047019","01- Annual","2014-01-01T00:00:00","339600","4195400","4535000","23348600","198297800","221646400"
"239","23353","14047019","01- Annual","2015-01-01T00:00:00","339600","6685000","7024600","25683400","203793900","229477300"
"240","23353","14047019","03- Board of Equalization","2015-11-03T00:00:00","339600","6592400","6932000","25683400","196751900","222435300"
"241","23353","14047019","01- Annual","2016-01-01T00:00:00","339600","6688000","7027600","27017600","201300800","228318400"
"242","23354","14047020","01- Annual","2016-01-01T00:00:00","387300","0","387300","30816400","0","30816400"
"243","23354","14047020","01- Annual","2015-01-01T00:00:00","387300","0","387300","29294600","0","29294600"
"244","23354","14047020","01- Annual","2014-01-01T00:00:00","387300","0","387300","26631400","0","26631400"
"245","23354","14047020","01- Annual","2017-01-01T00:00:00","387300","0","387300","32718600","0","32718600"
"246","23354","14047020","01- Annual","2018-01-01T00:00:00","387300","0","387300","32718600","0","32718600"
"247","23354","14047020","01- Annual","2013-01-01T00:00:00","387300","0","387300","26631400","0","26631400"
"248","23354","14047020","","2008-01-01T00:00:00","387300","0","387300","25109600","0","25109600"
"249","23354","14047020","","2009-01-01T00:00:00","387300","0","387300","25109600","0","25109600"
"250","23354","14047020","","2010-01-01T00:00:00","309800","0","309800","21305200","0","21305200"
"251","23354","14047020","","2011-01-01T00:00:00","355000","0","355000","22826900","0","22826900"
"252","23354","14047020","","2012-01-01T00:00:00","387300","0","387300","26631400","0","26631400"
"253","23846","14050036","","2012-01-01T00:00:00","588000","1857000","2445000","30660000","123550600","154210600"
"254","23846","14050036","","2011-01-01T00:00:00","539000","1105800","1644800","26280000","100065900","126345900"
"255","23846","14050036","","2010-01-01T00:00:00","470400","1083500","1553900","24528000","94678900","119206900"
"256","23846","14050036","","2009-01-01T00:00:00","588000","1177200","1765200","28908000","102627600","131535600"
"257","23846","14050036","","2008-01-01T00:00:00","588000","1274000","1862000","28908000","107826400","136734400"
"258","23846","14050036","01- Annual","2013-01-01T00:00:00","588000","4302000","4890000","30660000","121763100","152423100"
"259","23846","14050036","01- Annual","2018-01-01T00:00:00","588000","2963900","3551900","37410000","130926400","168336400"
"260","23846","14050036","01- Annual","2014-01-01T00:00:00","588000","2101500","2689500","30660000","135195800","165855800"
"261","23846","14050036","03- Board of Equalization","2014-09-09T00:00:00","588000","2101500","2689500","30660000","130982200","161642200"
"262","23846","14050036","01- Annual","2015-01-01T00:00:00","588000","2177200","2765200","33495000","129326900","162821900"
"263","23846","14050036","01- Annual","2016-01-01T00:00:00","588000","2286000","2874000","35235000","133728100","168963100"
"264","23846","14050036","01- Annual","2017-01-01T00:00:00","588000","3309900","3897900","37410000","124849300","162259300"
"265","23850","14051019","01- Annual","2017-01-01T00:00:00","552000","0","552000","20382000","1000","20383000"
"266","23850","14051019","01- Annual","2016-01-01T00:00:00","552000","0","552000","19197000","1000","19198000"
"267","23850","14051019","01- Annual","2015-01-01T00:00:00","552000","0","552000","18249000","1000","18250000"
"268","23850","14051019","01- Annual","2014-01-01T00:00:00","552000","0","552000","16590000","1000","16591000"
"269","23850","14051019","01- Annual","2018-01-01T00:00:00","552000","0","552000","20382000","1000","20383000"
"270","23850","14051019","01- Annual","2013-01-01T00:00:00","552000","0","552000","16590000","1000","16591000"
"271","23850","14051019","","2008-01-01T00:00:00","552000","0","552000","15642000","1000","15643000"
"272","23850","14051019","","2009-01-01T00:00:00","552000","0","552000","15642000","1000","15643000"
"273","23850","14051019","","2010-01-01T00:00:00","441600","0","441600","13272000","1000","13273000"
"274","23850","14051019","","2011-01-01T00:00:00","506000","0","506000","14220000","1000","14221000"
"275","23850","14051019","","2012-01-01T00:00:00","552000","0","552000","16590000","1000","16591000"
"276","24283","14060013","","2009-01-01T00:00:00","4325600","1000","4326600","2504300","0","2504300"
"277","24283","14060013","","2008-01-01T00:00:00","1767500","216700","1984200","0","0","0"
"278","24284","14060015","","2009-01-01T00:00:00","3478000","1000","3479000","2013600","0","2013600"
"279","24294","14060026","","2009-01-01T00:00:00","6064400","1000","6065400","3511000","0","3511000"
"280","24296","14060036","","2009-01-01T00:00:00","5345200","1000","5346200","3094600","0","3094600"
"281","24296","14060036","","2008-01-01T00:00:00","2329700","184000","2513700","0","0","0"
"282","24298","14060038","","2009-01-01T00:00:00","579300","1000","580300","335400","0","335400"
"283","24302","14060050","","2009-01-01T00:00:00","16897000","1000","16898000","9782400","0","9782400"
"284","24307","14060058","","2009-01-01T00:00:00","3758800","1000","3759800","2176100","0","2176100"
"285","24310","14060061","","2009-01-01T00:00:00","18000","0","18000","10400","0","10400"
"286","24313","14060065","","2009-01-01T00:00:00","801800","0","801800","464200","0","464200"
"287","25775","15062003","","2009-01-01T00:00:00","215200","164900","380100","132000","78700","210700"
"288","25775","15062003","","2008-01-01T00:00:00","215200","141300","356500","132000","51400","183400"
"289","25775","15062003","01- Annual","2013-01-01T00:00:00","227200","135500","362700","120000","95300","215300"
"290","25775","15062003","","2012-01-01T00:00:00","227200","127700","354900","120000","102600","222600"
"291","25775","15062003","","2011-01-01T00:00:00","237200","96200","333400","110000","94800","204800"
"292","25775","15062003","","2010-01-01T00:00:00","235200","96200","331400","112000","65800","177800"
"293","25775","15062003","01- Annual","2014-01-01T00:00:00","227200","135500","362700","120000","178800","298800"
"294","25815","15064001","","2010-01-01T00:00:00","367400","221200","588600","112000","70100","182100"
"295","25815","15064001","","2011-01-01T00:00:00","369400","235700","605100","110000","99600","209600"
"296","25815","15064001","","2012-01-01T00:00:00","359400","284800","644200","120000","112700","232700"
"297","25815","15064001","01- Annual","2013-01-01T00:00:00","359400","318100","677500","120000","95300","215300"
"298","25815","15064001","","2008-01-01T00:00:00","347400","303800","651200","132000","51400","183400"
"299","25815","15064001","","2009-01-01T00:00:00","347400","312000","659400","132000","83900","215900"
"300","25841","15066001","","2009-01-01T00:00:00","452400","424700","877100","132000","98500","230500"
"301","25841","15066001","","2008-01-01T00:00:00","452400","407700","860100","132000","59800","191800"
"302","25841","15066001","01- Annual","2013-01-01T00:00:00","464400","420400","884800","120000","104300","224300"
"303","25841","15066001","","2012-01-01T00:00:00","464400","387700","852100","120000","122900","242900"
"304","25841","15066001","","2011-01-01T00:00:00","474400","326000","800400","110000","109100","219100"
"305","25841","15066001","","2010-01-01T00:00:00","472400","323400","795800","112000","82500","194500"
"306","25841","15066001","01- Annual","2014-01-01T00:00:00","464400","437100","901500","120000","191300","311300"
"307","25841","15066001","01- Annual","2015-01-01T00:00:00","584400","317100","901500","0","316900","316900"
"308","25865","15067008","01- Annual","2015-01-01T00:00:00","560600","46200","606800","0","154600","154600"
"309","25865","15067008","01- Annual","2014-01-01T00:00:00","500600","68200","568800","60000","65300","125300"
"310","25865","15067008","","2010-01-01T00:00:00","504600","6100","510700","56000","43800","99800"
"311","25865","15067008","","2011-01-01T00:00:00","505600","20500","526100","55000","56900","111900"
"312","25865","15067008","","2012-01-01T00:00:00","500600","59500","560100","60000","61400","121400"
"313","25865","15067008","01- Annual","2013-01-01T00:00:00","500600","59500","560100","60000","65300","125300"
"314","25865","15067008","","2008-01-01T00:00:00","494600","48000","542600","66000","37700","103700"
"315","25865","15067008","","2009-01-01T00:00:00","494600","29300","523900","66000","46900","112900"
"316","25923","15070001","","2010-01-01T00:00:00","1480500","3893400","5373900","0","0","0"
"317","25996","15074008","","2010-01-01T00:00:00","27100","1029400","1056500","2311600","61292200","63603800"
"318","25996","15074008","","2012-01-01T00:00:00","33900","1688800","1722700","2899400","76248400","79147800"
"319","25996","15074008","","2011-01-01T00:00:00","31100","1395500","1426600","2485200","62575200","65060400"
"320","25996","15074008","","2009-01-01T00:00:00","33900","1247000","1280900","2724400","76490500","79214900"
"321","25996","15074008","","2008-01-01T00:00:00","33900","1293800","1327700","2724400","75149800","77874200"
"322","25996","15074008","01- Annual","2013-01-01T00:00:00","33900","1709800","1743700","2899400","11233800","14133200"
"323","25996","15074008","01- Annual","2014-01-01T00:00:00","33900","1863700","1897600","2899400","14075600","16975000"
"324","25996","15074008","01- Annual","2015-01-01T00:00:00","33900","1834500","1868400","3189400","14550400","17739800"
"325","25996","15074008","05- Review","2015-09-03T00:00:00","33900","1834500","1868400","3189400","14545500","17734900"
"326","25996","15074008","03- Board of Equalization","2016-09-19T00:00:00","33900","1862900","1896800","3355000","14651100","18006100"
"327","25996","15074008","01- Annual","2016-01-01T00:00:00","33900","1862900","1896800","3355000","14656500","18011500"
"328","25996","15074008","01- Annual","2018-01-01T00:00:00","33900","0","33900","3562100","0","3562100"
"329","25996","15074008","01- Annual","2017-01-01T00:00:00","33900","2262000","2295900","3562100","14549700","18111800"
"330","25997","15074009","01- Annual","2017-01-01T00:00:00","33900","0","33900","3562100","14549700","18111800"
"331","25997","15074009","01- Annual","2018-01-01T00:00:00","33900","0","33900","3562100","0","3562100"
"332","25997","15074009","01- Annual","2016-01-01T00:00:00","33900","0","33900","3355000","14656500","18011500"
"333","25997","15074009","03- Board of Equalization","2016-09-19T00:00:00","33900","0","33900","3355000","14651100","18006100"
"334","25997","15074009","05- Review","2015-09-03T00:00:00","33900","0","33900","3189400","14545500","17734900"
"335","25997","15074009","01- Annual","2015-01-01T00:00:00","33900","0","33900","3189400","14550400","17739800"
"336","25997","15074009","01- Annual","2014-01-01T00:00:00","33900","0","33900","2899400","14075600","16975000"
"337","25997","15074009","01- Annual","2013-01-01T00:00:00","33900","0","33900","2899400","11233800","14133200"
"338","25997","15074009","","2008-01-01T00:00:00","33900","0","33900","2724400","0","2724400"
"339","25997","15074009","","2009-01-01T00:00:00","33900","0","33900","2724400","0","2724400"
"340","25997","15074009","","2011-01-01T00:00:00","31100","0","31100","2485200","0","2485200"
"341","25997","15074009","","2012-01-01T00:00:00","33900","0","33900","2899400","0","2899400"
"342","25997","15074009","","2010-01-01T00:00:00","27100","0","27100","2311600","0","2311600"
"343","25998","15074010","","2010-01-01T00:00:00","20400","0","20400","1733700","0","1733700"
"344","25998","15074010","","2012-01-01T00:00:00","25400","0","25400","2174600","0","2174600"
"345","25998","15074010","","2011-01-01T00:00:00","23300","0","23300","1863900","0","1863900"
"346","25998","15074010","","2009-01-01T00:00:00","25400","0","25400","2043300","0","2043300"
"347","25998","15074010","","2008-01-01T00:00:00","25400","0","25400","2043300","0","2043300"
"348","25998","15074010","01- Annual","2013-01-01T00:00:00","25400","0","25400","2174600","8445300","10619900"
"349","25998","15074010","01- Annual","2014-01-01T00:00:00","25400","0","25400","2174600","10581600","12756200"
"350","25998","15074010","01- Annual","2015-01-01T00:00:00","25400","0","25400","2392000","10938600","13330600"
"351","25998","15074010","05- Review","2015-09-03T00:00:00","25400","0","25400","2392000","10934900","13326900"
"352","25998","15074010","03- Board of Equalization","2016-09-19T00:00:00","25400","0","25400","2516300","11014300","13530600"
"353","25998","15074010","01- Annual","2016-01-01T00:00:00","25400","0","25400","2516300","11018400","13534700"
"354","25998","15074010","01- Annual","2018-01-01T00:00:00","25400","0","25400","2671600","0","2671600"
"355","25998","15074010","01- Annual","2017-01-01T00:00:00","25400","0","25400","2671600","10938100","13609700"
"356","25999","15074011","01- Annual","2017-01-01T00:00:00","25700","0","25700","2695500","11041300","13736800"
"357","25999","15074011","01- Annual","2018-01-01T00:00:00","25700","0","25700","2695500","0","2695500"
"358","25999","15074011","01- Annual","2016-01-01T00:00:00","25700","0","25700","2538700","11122300","13661000"
"359","25999","15074011","03- Board of Equalization","2016-09-19T00:00:00","25700","0","25700","2538700","11118200","13656900"
"360","25999","15074011","05- Review","2015-09-03T00:00:00","25700","0","25700","2413400","11038000","13451400"
"361","25999","15074011","01- Annual","2015-01-01T00:00:00","25700","0","25700","2413400","11041800","13455200"
"362","25999","15074011","01- Annual","2014-01-01T00:00:00","25700","0","25700","2194000","10681500","12875500"
"363","25999","15074011","01- Annual","2013-01-01T00:00:00","25700","0","25700","2194000","8524900","10718900"
"364","25999","15074011","","2008-01-01T00:00:00","25700","0","25700","2061500","0","2061500"
"365","25999","15074011","","2009-01-01T00:00:00","25700","0","25700","2061500","0","2061500"
"366","25999","15074011","","2011-01-01T00:00:00","23500","0","23500","1880600","0","1880600"
"367","25999","15074011","","2012-01-01T00:00:00","25700","0","25700","2194000","0","2194000"
"368","25999","15074011","","2010-01-01T00:00:00","20500","0","20500","1749200","0","1749200"
"369","26000","15074012","","2010-01-01T00:00:00","13700","0","13700","1166100","0","1166100"
"370","26000","15074012","","2012-01-01T00:00:00","17100","0","17100","1462700","0","1462700"
"371","26000","15074012","","2011-01-01T00:00:00","15700","0","15700","1253700","0","1253700"
"372","26000","15074012","","2009-01-01T00:00:00","17100","0","17100","1374400","0","1374400"
"373","26000","15074012","","2008-01-01T00:00:00","17100","0","17100","1374400","0","1374400"
"374","26000","15074012","01- Annual","2013-01-01T00:00:00","17100","0","17100","1462700","5656700","7119400"
"375","26000","15074012","01- Annual","2014-01-01T00:00:00","17100","0","17100","1462700","7087700","8550400"
"376","26000","15074012","01- Annual","2015-01-01T00:00:00","17100","0","17100","1608900","7326800","8935700"
"377","26000","15074012","05- Review","2015-09-03T00:00:00","17100","0","17100","1608900","7324300","8933200"
"378","26000","15074012","03- Board of Equalization","2016-09-19T00:00:00","17100","0","17100","1692500","7377500","9070000"
"379","26000","15074012","01- Annual","2016-01-01T00:00:00","17100","0","17100","1692500","7380200","9072700"
"380","26000","15074012","01- Annual","2018-01-01T00:00:00","17100","0","17100","1797000","0","1797000"
"381","26000","15074012","01- Annual","2017-01-01T00:00:00","17100","0","17100","1797000","7326500","9123500"
"382","26001","15074013","01- Annual","2017-01-01T00:00:00","17100","0","17100","1797000","7326500","9123500"
"383","26001","15074013","01- Annual","2018-01-01T00:00:00","17100","0","17100","1797000","0","1797000"
"384","26001","15074013","01- Annual","2016-01-01T00:00:00","17100","0","17100","1692500","7380200","9072700"
"385","26001","15074013","03- Board of Equalization","2016-09-19T00:00:00","17100","0","17100","1692500","7377500","9070000"
"386","26001","15074013","05- Review","2015-09-03T00:00:00","17100","0","17100","1608900","7324300","8933200"
"387","26001","15074013","01- Annual","2015-01-01T00:00:00","17100","0","17100","1608900","7326800","8935700"
"388","26001","15074013","01- Annual","2014-01-01T00:00:00","17100","0","17100","1462700","7087700","8550400"
"389","26001","15074013","01- Annual","2013-01-01T00:00:00","17100","0","17100","1462700","5656700","7119400"
"390","26001","15074013","","2008-01-01T00:00:00","17100","0","17100","1374400","0","1374400"
"391","26001","15074013","","2009-01-01T00:00:00","17100","0","17100","1374400","0","1374400"
"392","26001","15074013","","2011-01-01T00:00:00","15700","0","15700","1253700","0","1253700"
"393","26001","15074013","","2012-01-01T00:00:00","17100","0","17100","1462700","0","1462700"
"394","26001","15074013","","2010-01-01T00:00:00","13700","0","13700","1166100","0","1166100"
"395","26002","15074014","","2010-01-01T00:00:00","13700","0","13700","1166100","0","1166100"
"396","26002","15074014","","2012-01-01T00:00:00","17100","0","17100","1462700","0","1462700"
"397","26002","15074014","","2011-01-01T00:00:00","15700","0","15700","1253700","0","1253700"
"398","26002","15074014","","2009-01-01T00:00:00","17100","0","17100","1374400","0","1374400"
"399","26002","15074014","","2008-01-01T00:00:00","17100","0","17100","1374400","0","1374400"
"400","26002","15074014","01- Annual","2013-01-01T00:00:00","17100","0","17100","1462700","5656700","7119400"
"401","26002","15074014","01- Annual","2014-01-01T00:00:00","17100","0","17100","1462700","7087700","8550400"
"402","26002","15074014","01- Annual","2015-01-01T00:00:00","17100","0","17100","1608900","7326800","8935700"
"403","26002","15074014","05- Review","2015-09-03T00:00:00","17100","0","17100","1608900","7324300","8933200"
"404","26002","15074014","03- Board of Equalization","2016-09-19T00:00:00","17100","0","17100","1692500","7377500","9070000"
"405","26002","15074014","01- Annual","2016-01-01T00:00:00","17100","0","17100","1692500","7380200","9072700"
"406","26002","15074014","01- Annual","2018-01-01T00:00:00","17100","0","17100","1797000","0","1797000"
"407","26002","15074014","01- Annual","2017-01-01T00:00:00","17100","0","17100","1797000","7326500","9123500"
"408","26003","15074015","01- Annual","2017-01-01T00:00:00","8600","0","8600","898500","3714800","4613300"
"409","26003","15074015","01- Annual","2018-01-01T00:00:00","8600","0","8600","898500","0","898500"
"410","26003","15074015","01- Annual","2016-01-01T00:00:00","8600","0","8600","846200","3742100","4588300"
"411","26003","15074015","03- Board of Equalization","2016-09-19T00:00:00","8600","0","8600","846200","3740700","4586900"
"412","26003","15074015","05- Review","2015-09-03T00:00:00","8600","0","8600","804500","3713700","4518200"
"413","26003","15074015","01- Annual","2015-01-01T00:00:00","8600","0","8600","804500","3715000","4519500"
"414","26003","15074015","01- Annual","2014-01-01T00:00:00","8600","0","8600","731300","3593800","4325100"
"415","26003","15074015","01- Annual","2013-01-01T00:00:00","8600","0","8600","731300","2868200","3599500"
"416","26003","15074015","","2008-01-01T00:00:00","8600","0","8600","687200","0","687200"
"417","26003","15074015","","2009-01-01T00:00:00","8600","0","8600","687200","0","687200"
"418","26003","15074015","","2011-01-01T00:00:00","7800","0","7800","626900","0","626900"
"419","26003","15074015","","2012-01-01T00:00:00","8600","0","8600","731300","0","731300"
"420","26003","15074015","","2010-01-01T00:00:00","6800","0","6800","583100","0","583100"
"421","26004","15074016","","2010-01-01T00:00:00","24600","0","24600","2094900","0","2094900"
"422","26004","15074016","","2012-01-01T00:00:00","30700","0","30700","2627600","0","2627600"
"423","26004","15074016","","2011-01-01T00:00:00","28200","0","28200","2252200","0","2252200"
"424","26004","15074016","","2009-01-01T00:00:00","30700","0","30700","2469000","0","2469000"
"425","26004","15074016","","2008-01-01T00:00:00","30700","0","30700","2469000","0","2469000"
"426","26004","15074016","01- Annual","2013-01-01T00:00:00","30700","0","30700","2627600","10198100","12825700"
"427","26004","15074016","01- Annual","2014-01-01T00:00:00","30700","0","30700","2627600","12777800","15405400"
"428","26004","15074016","01- Annual","2015-01-01T00:00:00","30700","0","30700","2890400","13208900","16099300"
"429","26004","15074016","05- Review","2015-09-03T00:00:00","30700","0","30700","2890400","13204300","16094700"
"430","26004","15074016","03- Board of Equalization","2016-09-19T00:00:00","30700","0","30700","3040500","13300300","16340800"
"431","26004","15074016","01- Annual","2016-01-01T00:00:00","30700","0","30700","3040500","13305200","16345700"
"432","26004","15074016","01- Annual","2018-01-01T00:00:00","30700","0","30700","3228200","0","3228200"
"433","26004","15074016","01- Annual","2017-01-01T00:00:00","30700","0","30700","3228200","13208300","16436500"
"434","26005","15074017","01- Annual","2017-01-01T00:00:00","6700","0","6700","703200","2889300","3592500"
"435","26005","15074017","01- Annual","2018-01-01T00:00:00","6700","0","6700","703200","0","703200"
"436","26005","15074017","01- Annual","2016-01-01T00:00:00","6700","0","6700","662300","2910500","3572800"
"437","26005","15074017","03- Board of Equalization","2016-09-19T00:00:00","6700","0","6700","662300","2909400","3571700"
"438","26005","15074017","05- Review","2015-09-03T00:00:00","6700","0","6700","629600","2888500","3518100"
"439","26005","15074017","01- Annual","2015-01-01T00:00:00","6700","0","6700","629600","2889400","3519000"
"440","26005","15074017","01- Annual","2014-01-01T00:00:00","6700","0","6700","572400","2795100","3367500"
"441","26005","15074017","01- Annual","2013-01-01T00:00:00","6700","0","6700","572400","2230800","2803200"
"442","26005","15074017","","2008-01-01T00:00:00","6700","0","6700","537800","0","537800"
"443","26005","15074017","","2009-01-01T00:00:00","6700","0","6700","537800","0","537800"
"444","26005","15074017","","2011-01-01T00:00:00","6100","0","6100","490600","0","490600"
"445","26005","15074017","","2012-01-01T00:00:00","6700","0","6700","572400","0","572400"
"446","26005","15074017","","2010-01-01T00:00:00","5400","0","5400","456300","0","456300"
"447","26006","15074018","","2010-01-01T00:00:00","12100","0","12100","1030100","0","1030100"
"448","26006","15074018","","2012-01-01T00:00:00","15100","0","15100","1292100","0","1292100"
"449","26006","15074018","","2011-01-01T00:00:00","13900","0","13900","1107500","0","1107500"
"450","26006","15074018","","2009-01-01T00:00:00","15100","0","15100","1214100","0","1214100"
"451","26006","15074018","","2008-01-01T00:00:00","15100","0","15100","1214100","0","1214100"
"452","26006","15074018","01- Annual","2013-01-01T00:00:00","15100","0","15100","1292100","5019400","6311500"
"453","26006","15074018","01- Annual","2014-01-01T00:00:00","15100","0","15100","1292100","6289100","7581200"
"454","26006","15074018","01- Annual","2015-01-01T00:00:00","15100","0","15100","1421300","6501300","7922600"
"455","26006","15074018","05- Review","2015-09-03T00:00:00","15100","0","15100","1421300","6499000","7920300"
"456","26006","15074018","03- Board of Equalization","2016-09-19T00:00:00","15100","0","15100","1495100","6546400","8041500"
"457","26006","15074018","01- Annual","2016-01-01T00:00:00","15100","0","15100","1495100","6548700","8043800"
"458","26006","15074018","01- Annual","2018-01-01T00:00:00","15100","0","15100","1587400","0","1587400"
"459","26006","15074018","01- Annual","2017-01-01T00:00:00","15100","0","15100","1587400","6500900","8088300"
"460","26007","15074019","01- Annual","2017-01-01T00:00:00","8600","0","8600","898500","3818000","4716500"
"461","26007","15074019","01- Annual","2018-01-01T00:00:00","8600","0","8600","898500","0","898500"
"462","26007","15074019","01- Annual","2016-01-01T00:00:00","8600","0","8600","846200","3846000","4692200"
"463","26007","15074019","03- Board of Equalization","2016-09-19T00:00:00","8600","0","8600","846200","3844900","4691100"
"464","26007","15074019","05- Review","2015-09-03T00:00:00","8600","0","8600","804500","3816900","4621400"
"465","26007","15074019","01- Annual","2015-01-01T00:00:00","8600","0","8600","804500","3818200","4622700"
"466","26007","15074019","01- Annual","2014-01-01T00:00:00","8600","0","8600","731300","3693600","4424900"
"467","26007","15074019","01- Annual","2013-01-01T00:00:00","8600","0","8600","731300","2947900","3679200"
"468","26007","15074019","","2008-01-01T00:00:00","8600","0","8600","687200","0","687200"
"469","26007","15074019","","2009-01-01T00:00:00","8600","0","8600","687200","0","687200"
"470","26007","15074019","","2011-01-01T00:00:00","7800","0","7800","626900","0","626900"
"471","26007","15074019","","2012-01-01T00:00:00","8600","0","8600","731300","0","731300"
"472","26007","15074019","","2010-01-01T00:00:00","6800","0","6800","583100","0","583100"
"473","26012","15075007","01- Annual","2017-01-01T00:00:00","8400","0","8400","2018000","1000","2019000"
"474","26012","15075007","01- Annual","2018-01-01T00:00:00","8400","0","8400","2018000","1000","2019000"
"475","26013","15075008","01- Annual","2018-01-01T00:00:00","1700","0","1700","403600","0","403600"
"476","26013","15075008","01- Annual","2017-01-01T00:00:00","1700","0","1700","403600","0","403600"
"477","26014","15075011","01- Annual","2017-01-01T00:00:00","12300","0","12300","2948000","0","2948000"
"478","26014","15075011","01- Annual","2018-01-01T00:00:00","12300","0","12300","2948000","0","2948000"
"479","26015","15075012","01- Annual","2018-01-01T00:00:00","4100","0","4100","982700","0","982700"
"480","26015","15075012","01- Annual","2017-01-01T00:00:00","4100","0","4100","982700","0","982700"
"481","26016","15075013","01- Annual","2017-01-01T00:00:00","8400","0","8400","2018000","1000","2019000"
"482","26016","15075013","01- Annual","2018-01-01T00:00:00","8400","0","8400","2018000","1000","2019000"
"483","26017","15075014","01- Annual","2018-01-01T00:00:00","12700","0","12700","3027000","0","3027000"
"484","26017","15075014","01- Annual","2017-01-01T00:00:00","12700","0","12700","3027000","0","3027000"
"485","26018","15075016","01- Annual","2017-01-01T00:00:00","8400","0","8400","2018000","0","2018000"
"486","26018","15075016","01- Annual","2018-01-01T00:00:00","8400","0","8400","2018000","0","2018000"
"487","26019","15075017","01- Annual","2018-01-01T00:00:00","6800","0","6800","1614400","0","1614400"
"488","26019","15075017","01- Annual","2017-01-01T00:00:00","6800","0","6800","1614400","0","1614400"
"489","26020","15075018","01- Annual","2017-01-01T00:00:00","16400","0","16400","3930700","0","3930700"
"490","26020","15075018","01- Annual","2018-01-01T00:00:00","16400","0","16400","3930700","0","3930700"
"491","26021","15075019","01- Annual","2018-01-01T00:00:00","4200","0","4200","1009000","1000","1010000"
"492","26021","15075019","01- Annual","2017-01-01T00:00:00","4200","0","4200","1009000","1000","1010000"
"493","26022","15075020","01- Annual","2017-01-01T00:00:00","33800","0","33800","8071900","1000","8072900"
"494","26022","15075020","01- Annual","2018-01-01T00:00:00","33800","0","33800","8071900","1000","8072900"
"495","26051","15078002","","2010-01-01T00:00:00","15000","59600","74600","56000","41200","97200"
"496","26051","15078002","","2012-01-01T00:00:00","11000","72500","83500","60000","56400","116400"
"497","26051","15078002","","2011-01-01T00:00:00","16000","59000","75000","55000","49800","104800"
"498","26051","15078002","","2009-01-01T00:00:00","5000","76500","81500","66000","49200","115200"
"499","26051","15078002","","2008-01-01T00:00:00","5000","76300","81300","66000","31900","97900"
"500","26051","15078002","01- Annual","2013-01-01T00:00:00","11000","81400","92400","60000","48800","108800"
"501","26052","15078003","01- Annual","2013-01-01T00:00:00","46800","1000","47800","462800","0","462800"
"502","26052","15078003","","2008-01-01T00:00:00","46800","1000","47800","436400","0","436400"
"503","26052","15078003","","2009-01-01T00:00:00","46800","1000","47800","436400","0","436400"
"504","26052","15078003","","2011-01-01T00:00:00","42900","1000","43900","396700","0","396700"
"505","26052","15078003","","2012-01-01T00:00:00","46800","1000","47800","462800","0","462800"
"506","26052","15078003","","2010-01-01T00:00:00","37500","1000","38500","370300","0","370300"
"507","26053","15078004","","2010-01-01T00:00:00","167100","1000","168100","1651100","0","1651100"
"508","26053","15078004","","2012-01-01T00:00:00","208800","1000","209800","2063900","0","2063900"
"509","26053","15078004","","2011-01-01T00:00:00","191400","1000","192400","1769100","0","1769100"
"510","26053","15078004","","2009-01-01T00:00:00","208800","1000","209800","1946000","0","1946000"
"511","26053","15078004","","2008-01-01T00:00:00","208800","1000","209800","1946000","0","1946000"
"512","26053","15078004","01- Annual","2013-01-01T00:00:00","208900","1000","209900","2063900","0","2063900"
"513","26054","15078005","01- Annual","2013-01-01T00:00:00","91200","0","91200","901600","0","901600"
"514","26054","15078005","","2008-01-01T00:00:00","91200","0","91200","850100","0","850100"
"515","26054","15078005","","2009-01-01T00:00:00","91200","0","91200","850100","0","850100"
"516","26054","15078005","","2011-01-01T00:00:00","83600","0","83600","772800","0","772800"
"517","26054","15078005","","2012-01-01T00:00:00","91200","0","91200","901600","0","901600"
"518","26054","15078005","","2010-01-01T00:00:00","73000","0","73000","721300","0","721300"
"519","26055","15078006","01- Annual","2018-01-01T00:00:00","19900","0","19900","4758900","1000","4759900"
"520","26055","15078006","01- Annual","2017-01-01T00:00:00","19900","0","19900","4758900","1000","4759900"
"521","26056","15078010","01- Annual","2017-01-01T00:00:00","8400","0","8400","2018000","1000","2019000"
"522","26056","15078010","01- Annual","2018-01-01T00:00:00","8400","0","8400","2018000","1000","2019000"
"523","26057","15078011","01- Annual","2018-01-01T00:00:00","6300","0","6300","1513700","0","1513700"
"524","26057","15078011","01- Annual","2017-01-01T00:00:00","6300","0","6300","1513700","0","1513700"
"525","26058","15078012","01- Annual","2017-01-01T00:00:00","4100","0","4100","982700","0","982700"
"526","26058","15078012","01- Annual","2018-01-01T00:00:00","4100","0","4100","982700","0","982700"
"527","26059","15078013","","2010-01-01T00:00:00","116800","0","116800","1153900","0","1153900"
"528","26059","15078013","","2012-01-01T00:00:00","146000","0","146000","1442400","0","1442400"
"529","26059","15078013","","2011-01-01T00:00:00","133800","0","133800","1236400","0","1236400"
"530","26059","15078013","","2009-01-01T00:00:00","146000","0","146000","1360000","0","1360000"
"531","26059","15078013","","2008-01-01T00:00:00","146000","1000","147000","1360000","0","1360000"
"532","26059","15078013","01- Annual","2013-01-01T00:00:00","146000","0","146000","1442400","0","1442400"
"533","26060","15078014","01- Annual","2013-01-01T00:00:00","97300","0","97300","961600","0","961600"
"534","26060","15078014","","2008-01-01T00:00:00","97300","0","97300","906700","0","906700"
"535","26060","15078014","","2009-01-01T00:00:00","97300","0","97300","906700","0","906700"
"536","26060","15078014","","2011-01-01T00:00:00","89200","0","89200","824200","0","824200"
"537","26060","15078014","","2012-01-01T00:00:00","97300","0","97300","961600","0","961600"
"538","26060","15078014","","2010-01-01T00:00:00","77900","0","77900","769300","0","769300"
"539","26061","15078015","","2010-01-01T00:00:00","97300","0","97300","961600","0","961600"
"540","26061","15078015","","2012-01-01T00:00:00","121600","0","121600","1202000","0","1202000"
"541","26061","15078015","","2011-01-01T00:00:00","111500","0","111500","1030300","0","1030300"
"542","26061","15078015","","2009-01-01T00:00:00","121600","0","121600","1133300","0","1133300"
"543","26061","15078015","","2008-01-01T00:00:00","121600","1000","122600","1133300","0","1133300"
"544","26061","15078015","01- Annual","2013-01-01T00:00:00","121600","0","121600","1202000","0","1202000"
"545","26062","15078016","01- Annual","2013-01-01T00:00:00","121600","0","121600","1202000","0","1202000"
"546","26062","15078016","","2008-01-01T00:00:00","121600","0","121600","1133300","0","1133300"
"547","26062","15078016","","2009-01-01T00:00:00","121600","0","121600","1133300","0","1133300"
"548","26062","15078016","","2011-01-01T00:00:00","111500","0","111500","1030300","0","1030300"
"549","26062","15078016","","2012-01-01T00:00:00","121600","0","121600","1202000","0","1202000"
"550","26062","15078016","","2010-01-01T00:00:00","97300","0","97300","961600","0","961600"
"551","26063","15078017","","2010-01-01T00:00:00","97300","0","97300","961600","0","961600"
"552","26063","15078017","","2012-01-01T00:00:00","121600","0","121600","1202000","0","1202000"
"553","26063","15078017","","2011-01-01T00:00:00","111500","0","111500","1030300","0","1030300"
"554","26063","15078017","","2009-01-01T00:00:00","121600","0","121600","1133300","0","1133300"
"555","26063","15078017","","2008-01-01T00:00:00","121600","1000","122600","1133300","0","1133300"
"556","26063","15078017","01- Annual","2013-01-01T00:00:00","121600","0","121600","1202000","0","1202000"
"557","26064","15078018","01- Annual","2013-01-01T00:00:00","96600","0","96600","954300","0","954300"
"558","26064","15078018","","2008-01-01T00:00:00","96600","0","96600","899800","0","899800"
"559","26064","15078018","","2009-01-01T00:00:00","96600","0","96600","899800","0","899800"
"560","26064","15078018","","2011-01-01T00:00:00","88500","0","88500","818000","0","818000"
"561","26064","15078018","","2012-01-01T00:00:00","96600","0","96600","954300","0","954300"
"562","26064","15078018","","2010-01-01T00:00:00","77300","0","77300","763400","0","763400"
"563","26066","15078021","01- Annual","2018-01-01T00:00:00","6300","0","6300","1513700","1000","1514700"
"564","26066","15078021","01- Annual","2017-01-01T00:00:00","6300","0","6300","1513700","1000","1514700"
"565","26067","15078022","01- Annual","2017-01-01T00:00:00","9600","0","9600","2304400","0","2304400"
"566","26067","15078022","01- Annual","2018-01-01T00:00:00","9600","0","9600","2304400","0","2304400"
"567","26068","15078023","","2010-01-01T00:00:00","37000","1000","38000","365800","0","365800"
"568","26068","15078023","","2012-01-01T00:00:00","46300","1000","47300","457200","0","457200"
"569","26068","15078023","","2011-01-01T00:00:00","42400","1000","43400","391900","0","391900"
"570","26068","15078023","","2009-01-01T00:00:00","46300","1000","47300","431100","0","431100"
"571","26068","15078023","","2008-01-01T00:00:00","46300","1000","47300","431100","0","431100"
"572","26068","15078023","01- Annual","2013-01-01T00:00:00","46300","1000","47300","457200","0","457200"
"573","26069","15078024","01- Annual","2018-01-01T00:00:00","36600","0","36600","8747500","0","8747500"
"574","26069","15078024","01- Annual","2017-01-01T00:00:00","36600","0","36600","8747500","0","8747500"
"575","26395","15087028","01- Annual","2018-01-01T00:00:00","58682100","211584500","270266600","0","0","0"
"576","26395","15087028","01- Annual","2014-01-01T00:00:00","58682100","230061900","288744000","0","0","0"
"577","26395","15087028","01- Annual","2015-01-01T00:00:00","58682100","228099100","286781200","0","0","0"
"578","26395","15087028","03- Board of Equalization","2015-10-07T00:00:00","58682100","214418000","273100100","0","0","0"
"579","26395","15087028","01- Annual","2016-01-01T00:00:00","58682100","217162600","275844700","0","0","0"
"580","27080","16022001","","2008-01-01T00:00:00","264000","234500","498500","34020000","23213800","57233800"
"581","27080","16022001","","2009-01-01T00:00:00","264000","982800","1246800","34020000","97301600","131321600"
"582","27080","16022001","","2009-07-01T00:00:00","0","32638400","32638400","0","309900","309900"
"583","28251","16034001","","2010-01-01T00:00:00","152800","1104000","1256800","14593100","65774600","80367700"
"584","28251","16034001","","2011-01-01T00:00:00","175000","1190200","1365200","15635400","71909000","87544400"
"585","28251","16034001","","2012-01-01T00:00:00","222800","1277200","1500000","18241400","87823500","106064900"
"586","28251","16034001","","2009-01-01T00:00:00","191000","1270300","1461300","17199000","78407400","95606400"
"587","28251","16034001","","2008-01-01T00:00:00","191000","1402100","1593100","17199000","81695200","98894200"
"588","28251","16034001","01- Annual","2013-01-01T00:00:00","222800","1277200","1500000","18241400","91101700","109343100"
"589","28251","16034001","05- Review","2015-09-03T00:00:00","191000","1460500","1651500","20065500","96012600","116078100"
"590","28251","16034001","03- Board of Equalization","2016-09-06T00:00:00","191000","1483600","1674600","21107900","96389100","117497000"
"591","28251","16034001","01- Annual","2016-01-01T00:00:00","191000","1483600","1674600","21107900","96443400","117551300"
"592","28251","16034001","01- Annual","2015-01-01T00:00:00","191000","1510200","1701200","20065500","104653600","124719100"
"593","28251","16034001","01- Annual","2014-01-01T00:00:00","222800","1370900","1593700","18241400","101262500","119503900"
"594","28251","16034001","01- Annual","2018-01-01T00:00:00","190900","0","190900","22404100","0","22404100"
"595","28251","16034001","03- Board of Equalization","2017-08-31T00:00:00","190900","1196900","1387800","22404100","94771500","117175600"
"596","28251","16034001","01- Annual","2017-01-01T00:00:00","190900","1604100","1795000","22404100","94771500","117175600"
"597","28252","16034002","01- Annual","2017-01-01T00:00:00","17900","0","17900","2100000","0","2100000"
"598","28252","16034002","01- Annual","2018-01-01T00:00:00","17900","0","17900","2100000","0","2100000"
"599","28252","16034002","01- Annual","2014-01-01T00:00:00","20800","0","20800","1706800","0","1706800"
"600","28252","16034002","01- Annual","2015-01-01T00:00:00","17900","0","17900","1877500","0","1877500"
"601","28252","16034002","01- Annual","2016-01-01T00:00:00","17900","0","17900","1975000","0","1975000"
"602","28252","16034002","01- Annual","2013-01-01T00:00:00","20800","0","20800","1706800","0","1706800"
"603","28252","16034002","","2008-01-01T00:00:00","17900","0","17900","1609200","0","1609200"
"604","28252","16034002","","2009-01-01T00:00:00","17900","0","17900","1609200","0","1609200"
"605","28252","16034002","","2012-01-01T00:00:00","20800","0","20800","1706800","0","1706800"
"606","28252","16034002","","2011-01-01T00:00:00","16400","0","16400","1462900","0","1462900"
"607","28252","16034002","","2010-01-01T00:00:00","14300","0","14300","1365400","0","1365400"
"608","28255","16034031","","2010-01-01T00:00:00","17000","0","17000","1625500","0","1625500"
"609","28255","16034031","","2011-01-01T00:00:00","19500","0","19500","1741600","0","1741600"
"610","28255","16034031","","2012-01-01T00:00:00","24800","0","24800","2031900","0","2031900"
"611","28255","16034031","","2009-01-01T00:00:00","21300","0","21300","1915800","0","1915800"
"612","28255","16034031","","2008-01-01T00:00:00","21300","0","21300","1915800","0","1915800"
"613","28255","16034031","01- Annual","2013-01-01T00:00:00","24800","0","24800","2031900","0","2031900"
"614","28255","16034031","01- Annual","2016-01-01T00:00:00","21300","0","21300","2351200","0","2351200"
"615","28255","16034031","01- Annual","2015-01-01T00:00:00","21300","0","21300","2235100","0","2235100"
"616","28255","16034031","01- Annual","2014-01-01T00:00:00","24800","0","24800","2031900","0","2031900"
"617","28255","16034031","01- Annual","2018-01-01T00:00:00","21300","0","21300","2500000","0","2500000"
"618","28255","16034031","01- Annual","2017-01-01T00:00:00","21300","0","21300","2500000","0","2500000"
"619","28617","16038001","","2008-11-01T00:00:00","9962200","1000","9963200","6682100","0","6682100"
"620","28617","16038001","","2008-01-01T00:00:00","9255900","1000","9256900","5793400","0","5793400"
"621","28617","16038001","","2009-01-01T00:00:00","9962200","1000","9963200","6682100","0","6682100"
"622","28618","16038002","","2009-01-01T00:00:00","344400","0","344400","231000","0","231000"
"623","28618","16038002","","2008-01-01T00:00:00","369100","0","369100","231000","0","231000"
"624","28618","16038002","","2008-11-01T00:00:00","344400","0","344400","231000","0","231000"
"625","28619","16038003","","2008-11-01T00:00:00","4849700","1000","4850700","3252900","0","3252900"
"626","28619","16038003","","2008-01-01T00:00:00","4505800","1000","4506800","2820300","0","2820300"
"627","28619","16038003","","2009-01-01T00:00:00","4849700","1000","4850700","3252900","0","3252900"
"628","28620","16038004","","2008-01-01T00:00:00","4859500","0","4859500","3041600","0","3041600"
"629","28621","16038005","","2008-01-01T00:00:00","6224800","1000","6225800","3896200","0","3896200"
"630","28621","16038005","","2009-01-01T00:00:00","6699800","1000","6700800","4493900","0","4493900"
"631","28621","16038005","","2008-11-01T00:00:00","6699800","1000","6700800","4493900","0","4493900"
"632","28622","16038006","","2008-11-01T00:00:00","4728200","0","4728200","3171400","0","3171400"
"633","28622","16038006","","2009-01-01T00:00:00","4728200","0","4728200","3171400","0","3171400"
"634","28622","16038006","","2008-01-01T00:00:00","4392900","0","4392900","2749600","0","2749600"
"635","28623","16038008","","2008-01-01T00:00:00","2196500","1000","2197500","1374800","0","1374800"
"636","28623","16038008","","2009-01-01T00:00:00","2364100","1000","2365100","1585700","0","1585700"
"637","28623","16038008","","2008-11-01T00:00:00","2364100","1000","2365100","1585700","0","1585700"
"638","28624","16038009","","2008-11-01T00:00:00","2642100","0","2642100","1772200","0","1772200"
"639","28624","16038009","","2009-01-01T00:00:00","2642100","0","2642100","1772200","0","1772200"
"640","28624","16038009","","2008-01-01T00:00:00","2454800","0","2454800","1536500","0","1536500"
"641","28625","16038010","","2008-01-01T00:00:00","2196500","0","2196500","1374800","0","1374800"
"642","28625","16038010","","2009-01-01T00:00:00","2364100","0","2364100","1585700","0","1585700"
"643","28625","16038010","","2008-11-01T00:00:00","2364100","0","2364100","1585700","0","1585700"
"644","28626","16038011","","2008-11-01T00:00:00","74700","0","74700","50100","0","50100"
"645","28626","16038011","","2009-01-01T00:00:00","74700","0","74700","50100","0","50100"
"646","28626","16038011","","2008-01-01T00:00:00","69400","0","69400","43400","0","43400"
"647","28627","16038012","","2008-01-01T00:00:00","169100","0","169100","105900","0","105900"
"648","28627","16038012","","2009-01-01T00:00:00","182000","0","182000","122100","0","122100"
"649","28627","16038012","","2008-11-01T00:00:00","182000","0","182000","122100","0","122100"
"650","28628","16038013","","2008-11-01T00:00:00","227900","0","227900","152900","0","152900"
"651","28628","16038013","","2009-01-01T00:00:00","227900","0","227900","152900","0","152900"
"652","28628","16038013","","2008-01-01T00:00:00","211700","0","211700","132500","0","132500"
"653","28665","17003010","01- Annual","2013-01-01T00:00:00","0","0","0","333200","0","333200"
"654","28665","17003010","","2012-01-01T00:00:00","0","0","0","333200","0","333200"
"655","28665","17003010","","2011-01-01T00:00:00","0","0","0","287000","0","287000"
"656","28665","17003010","","2010-01-01T00:00:00","0","0","0","269200","0","269200"
"657","28665","17003010","01- Annual","2017-01-01T00:00:00","0","0","0","2788600","0","2788600"
"658","28665","17003010","01- Annual","2018-01-01T00:00:00","0","0","0","2434300","0","2434300"
"659","28665","17003010","01- Annual","2014-01-01T00:00:00","0","0","0","333200","0","333200"
"660","28665","17003010","01- Annual","2015-01-01T00:00:00","0","0","0","369200","0","369200"
"661","28665","17003010","01- Annual","2016-01-01T00:00:00","0","0","0","2626500","0","2626500"
"662","28666","17003011","01- Annual","2016-01-01T00:00:00","0","0","0","2626500","0","2626500"
"663","28666","17003011","01- Annual","2015-01-01T00:00:00","0","0","0","369200","0","369200"
"664","28666","17003011","01- Annual","2014-01-01T00:00:00","0","0","0","333200","0","333200"
"665","28666","17003011","01- Annual","2018-01-01T00:00:00","0","0","0","2434300","0","2434300"
"666","28666","17003011","01- Annual","2017-01-01T00:00:00","0","0","0","2788600","0","2788600"
"667","28666","17003011","","2010-01-01T00:00:00","0","0","0","269200","0","269200"
"668","28666","17003011","","2011-01-01T00:00:00","0","0","0","287000","0","287000"
"669","28666","17003011","","2012-01-01T00:00:00","0","0","0","333200","0","333200"
"670","28666","17003011","01- Annual","2013-01-01T00:00:00","0","0","0","333200","0","333200"
"671","28667","17003012","01- Annual","2013-01-01T00:00:00","0","0","0","888000","0","888000"
"672","28667","17003012","","2012-01-01T00:00:00","0","0","0","888000","0","888000"
"673","28667","17003012","","2011-01-01T00:00:00","0","0","0","762400","0","762400"
"674","28667","17003012","","2010-01-01T00:00:00","0","0","0","711700","0","711700"
"675","28667","17003012","01- Annual","2017-01-01T00:00:00","0","0","0","7361900","0","7361900"
"676","28667","17003012","01- Annual","2018-01-01T00:00:00","0","0","0","6426700","0","6426700"
"677","28667","17003012","01- Annual","2014-01-01T00:00:00","0","0","0","888000","0","888000"
"678","28667","17003012","01- Annual","2015-01-01T00:00:00","0","0","0","973900","0","973900"
"679","28667","17003012","01- Annual","2016-01-01T00:00:00","0","0","0","6933900","0","6933900"
"680","28926","17003298","01- Annual","2016-01-01T00:00:00","0","0","0","131300","0","131300"
"681","28926","17003298","01- Annual","2015-01-01T00:00:00","0","0","0","20900","0","20900"
"682","28926","17003298","01- Annual","2014-01-01T00:00:00","0","0","0","16700","0","16700"
"683","28926","17003298","01- Annual","2018-01-01T00:00:00","0","0","0","121700","0","121700"
"684","28926","17003298","01- Annual","2017-01-01T00:00:00","0","0","0","139400","0","139400"
"685","28926","17003298","","2010-01-01T00:00:00","0","0","0","13300","0","13300"
"686","28926","17003298","","2011-01-01T00:00:00","0","0","0","14200","0","14200"
"687","28926","17003298","","2012-01-01T00:00:00","0","0","0","16700","0","16700"
"688","28926","17003298","01- Annual","2013-01-01T00:00:00","0","0","0","16700","0","16700"
"689","28927","17003299","01- Annual","2013-01-01T00:00:00","0","0","0","41700","0","41700"
"690","28927","17003299","","2012-01-01T00:00:00","0","0","0","41700","0","41700"
"691","28927","17003299","","2011-01-01T00:00:00","0","0","0","36000","0","36000"
"692","28927","17003299","","2010-01-01T00:00:00","0","0","0","33600","0","33600"
"693","28927","17003299","01- Annual","2017-01-01T00:00:00","0","0","0","348500","0","348500"
"694","28927","17003299","01- Annual","2018-01-01T00:00:00","0","0","0","304200","0","304200"
"695","28927","17003299","01- Annual","2014-01-01T00:00:00","0","0","0","41700","0","41700"
"696","28927","17003299","01- Annual","2015-01-01T00:00:00","0","0","0","48400","0","48400"
"697","28927","17003299","01- Annual","2016-01-01T00:00:00","0","0","0","328200","0","328200"
"698","28928","17003300","01- Annual","2016-01-01T00:00:00","0","0","0","328200","0","328200"
"699","28928","17003300","01- Annual","2015-01-01T00:00:00","0","0","0","48400","0","48400"
"700","28928","17003300","01- Annual","2014-01-01T00:00:00","0","0","0","41700","0","41700"
"701","28928","17003300","01- Annual","2018-01-01T00:00:00","0","0","0","304200","0","304200"
"702","28928","17003300","01- Annual","2017-01-01T00:00:00","0","0","0","348500","0","348500"
"703","28928","17003300","","2010-01-01T00:00:00","0","0","0","33600","0","33600"
"704","28928","17003300","","2011-01-01T00:00:00","0","0","0","36000","0","36000"
"705","28928","17003300","","2012-01-01T00:00:00","0","0","0","41700","0","41700"
"706","28928","17003300","01- Annual","2013-01-01T00:00:00","0","0","0","41700","0","41700"
"707","29225","17005002","","2012-01-01T00:00:00","117400","0","117400","5599100","0","5599100"
"708","29225","17005002","","2011-01-01T00:00:00","107600","0","107600","4799200","0","4799200"
"709","29225","17005002","","2010-01-01T00:00:00","93900","0","93900","4518000","0","4518000"
"710","29226","17005003","","2010-01-01T00:00:00","63300","0","63300","3043300","0","3043300"
"711","29226","17005003","","2011-01-01T00:00:00","72500","0","72500","3232700","0","3232700"
"712","29226","17005003","","2012-01-01T00:00:00","79100","0","79100","3771500","0","3771500"
"713","29227","17005004","","2012-01-01T00:00:00","80400","0","80400","3835100","0","3835100"
"714","29227","17005004","","2011-01-01T00:00:00","73700","0","73700","3287300","0","3287300"
"715","29227","17005004","","2010-01-01T00:00:00","64300","0","64300","3094600","0","3094600"
"716","29229","17005006","","2010-01-01T00:00:00","117600","0","117600","5656000","0","5656000"
"717","29229","17005006","","2011-01-01T00:00:00","134700","0","134700","6008100","0","6008100"
"718","29229","17005006","","2012-01-01T00:00:00","147000","0","147000","7009400","0","7009400"
"719","29230","17005007","","2012-01-01T00:00:00","42800","0","42800","2042500","0","2042500"
"720","29230","17005007","","2011-01-01T00:00:00","39300","0","39300","1750700","0","1750700"
"721","29230","17005007","","2010-01-01T00:00:00","34300","0","34300","1648200","0","1648200"
"722","29231","17005008","","2010-01-01T00:00:00","41200","0","41200","1982600","0","1982600"
"723","29231","17005008","","2011-01-01T00:00:00","47200","0","47200","2106000","0","2106000"
"724","29231","17005008","","2012-01-01T00:00:00","51500","0","51500","2457000","0","2457000"
"725","29232","17005009","","2012-01-01T00:00:00","53900","0","53900","2572900","0","2572900"
"726","29232","17005009","","2011-01-01T00:00:00","49500","0","49500","2205300","0","2205300"
"727","29232","17005009","","2010-01-01T00:00:00","43200","0","43200","2076100","0","2076100"
"728","29233","17005010","","2010-01-01T00:00:00","45100","0","45100","2169800","0","2169800"
"729","29233","17005010","","2011-01-01T00:00:00","51700","0","51700","2304900","0","2304900"
"730","29233","17005010","","2012-01-01T00:00:00","56400","0","56400","2689000","0","2689000"
"731","29234","17005011","","2012-01-01T00:00:00","129500","0","129500","6178400","0","6178400"
"732","29234","17005011","","2011-01-01T00:00:00","118700","0","118700","5295800","0","5295800"
"733","29234","17005011","","2010-01-01T00:00:00","103600","0","103600","4985400","0","4985400"
"734","29283","17011006","","2011-01-01T00:00:00","102000","0","102000","893200","0","893200"
"735","29283","17011006","","2012-01-01T00:00:00","110700","0","110700","1036700","0","1036700"
"736","29284","17011007","","2012-01-01T00:00:00","88400","0","88400","828100","0","828100"
"737","29284","17011007","","2011-01-01T00:00:00","81400","0","81400","713400","0","713400"
"738","29285","17011008","","2011-01-01T00:00:00","62100","0","62100","544500","0","544500"
"739","29285","17011008","","2012-01-01T00:00:00","67500","0","67500","631900","0","631900"
"740","29286","17011009","","2011-01-01T00:00:00","109100","0","109100","558000","0","558000"
"741","29286","17011009","","2010-01-01T00:00:00","95200","0","95200","520800","0","520800"
"742","29286","17011009","","2008-01-01T00:00:00","125700","0","125700","562000","1000","563000"
"743","29286","17011009","","2009-01-01T00:00:00","125700","0","125700","562000","0","562000"
"744","29289","17011013","","2009-01-01T00:00:00","200200","0","200200","895100","0","895100"
"745","29289","17011013","","2008-01-01T00:00:00","200200","0","200200","895100","1000","896100"
"746","29289","17011013","","2010-01-01T00:00:00","151600","0","151600","829500","0","829500"
"747","29289","17011013","","2011-01-01T00:00:00","173700","0","173700","888700","0","888700"
"748","29290","17011015","","2011-01-01T00:00:00","408400","0","408400","2089200","0","2089200"
"749","29290","17011015","","2010-01-01T00:00:00","356400","0","356400","1949900","0","1949900"
"750","29290","17011015","","2008-01-01T00:00:00","470500","0","470500","2104100","1000","2105100"
"751","29290","17011015","","2009-01-01T00:00:00","470500","0","470500","2104100","0","2104100"
"752","29291","17011016","","2009-01-01T00:00:00","1284700","0","1284700","5744800","0","5744800"
"753","29291","17011016","","2008-01-01T00:00:00","1284700","0","1284700","5744800","1000","5745800"
"754","29291","17011016","","2010-01-01T00:00:00","973100","0","973100","5323800","0","5323800"
"755","29291","17011016","","2011-01-01T00:00:00","1115000","0","1115000","5704100","0","5704100"
"756","29292","17011017","","2011-01-01T00:00:00","504200","1000","505200","4416800","0","4416800"
"757","29293","17011018","","2011-01-01T00:00:00","485400","1000","486400","4252100","0","4252100"
"758","29318","17012012","01- Annual","2014-01-01T00:00:00","966000","1928300","2894300","0","0","0"
"759","29319","17012013","01- Annual","2014-01-01T00:00:00","0","0","0","642700","0","642700"
"760","29329","17013017","01- Annual","2014-01-01T00:00:00","40700","429800","470500","18233500","107386200","125619700"
"761","29329","17013017","01- Annual","2015-01-01T00:00:00","40700","534900","575600","23399600","113152300","136551900"
"762","29329","17013017","01- Annual","2016-01-01T00:00:00","40700","585800","626500","24615200","121357900","145973100"
"763","29329","17013017","01- Annual","2017-01-01T00:00:00","40700","667100","707800","26134700","120873000","147007700"
"764","29329","17013017","01- Annual","2018-01-01T00:00:00","40700","0","40700","26134700","0","26134700"
"765","29329","17013017","","2011-01-01T00:00:00","37300","347900","385200","18233500","91410800","109644300"
"766","29329","17013017","","2012-01-01T00:00:00","40700","371800","412500","18233500","105987600","124221100"
"767","29329","17013017","","2010-01-01T00:00:00","32600","346000","378600","17041700","76112000","93153700"
"768","29329","17013017","","2008-01-01T00:00:00","40700","385300","426000","20084800","85644400","105729200"
"769","29329","17013017","","2009-01-01T00:00:00","40700","353900","394600","20084800","85644400","105729200"
"770","29329","17013017","01- Annual","2013-01-01T00:00:00","40700","382000","422700","18233500","106396000","124629500"
"771","29330","17013019","01- Annual","2013-01-01T00:00:00","55300","0","55300","24786500","84620100","109406600"
"772","29330","17013019","","2009-01-01T00:00:00","55300","0","55300","27303200","68087300","95390500"
"773","29330","17013019","","2008-01-01T00:00:00","55300","0","55300","27303200","68087300","95390500"
"774","29330","17013019","","2010-01-01T00:00:00","44200","0","44200","23166300","60509100","83675400"
"775","29330","17013019","","2012-01-01T00:00:00","55300","0","55300","24786500","84295300","109081800"
"776","29330","17013019","","2011-01-01T00:00:00","50700","0","50700","24786500","72702000","97488500"
"777","29330","17013019","01- Annual","2018-01-01T00:00:00","55300","0","55300","35527300","0","35527300"
"778","29330","17013019","01- Annual","2017-01-01T00:00:00","55300","0","55300","35527300","96134100","131661400"
"779","29330","17013019","01- Annual","2016-01-01T00:00:00","55300","0","55300","33461800","96519900","129981700"
"780","29330","17013019","01- Annual","2015-01-01T00:00:00","55300","0","55300","31809400","89993700","121803100"
"781","29330","17013019","01- Annual","2014-01-01T00:00:00","55300","0","55300","24786500","85407700","110194200"
"782","29332","17014001","01- Annual","2015-01-01T00:00:00","901700","4339700","5241400","19558000","73950000","93508000"
"783","29332","17014001","01- Annual","2017-01-01T00:00:00","901700","4960400","5862100","21844000","74540500","96384500"
"784","29332","17014001","01- Annual","2016-01-01T00:00:00","901700","4793800","5695500","20574000","68005100","88579100"
"785","29332","17014001","05- Review","2015-07-28T00:00:00","901700","4564800","5466500","19558000","65459600","85017600"
"786","29332","17014001","01- Annual","2018-01-01T00:00:00","901700","4285100","5186800","21844000","77764800","99608800"
"787","29332","17014001","","2011-01-01T00:00:00","826500","0","826500","15240000","20000","15260000"
"788","29332","17014001","","2012-01-01T00:00:00","901700","0","901700","17780000","20000","17800000"
"789","29332","17014001","","2010-01-01T00:00:00","721300","0","721300","14224000","20000","14244000"
"790","29332","17014001","01- Annual","2013-01-01T00:00:00","901700","0","901700","17780000","0","17780000"
"791","32270","18003111","01- Annual","2013-01-01T00:00:00","108000","940800","1048800","40250000","161311500","201561500"
"792","32270","18003111","","2008-01-01T00:00:00","108000","862100","970100","37950000","124587400","162537400"
"793","32270","18003111","","2009-01-01T00:00:00","108000","972700","1080700","37950000","142916200","180866200"
"794","32270","18003111","","2010-01-01T00:00:00","86400","839900","926300","32200000","120695200","152895200"
"795","32270","18003111","","2009-11-01T00:00:00","108000","861100","969100","37950000","134205800","172155800"
"796","32270","18003111","","2012-01-01T00:00:00","108000","940800","1048800","34500000","150231700","184731700"
"797","32270","18003111","","2011-01-01T00:00:00","99000","866800","965800","34500000","131019300","165519300"
"798","32270","18003111","01- Annual","2018-01-01T00:00:00","108000","1091900","1199900","49450000","141612200","191062200"
"799","32270","18003111","03- Board of Equalization","2017-10-10T00:00:00","108000","866900","974900","49450000","137262000","186712000"
"800","32270","18003111","03- Board of Equalization","2016-09-07T00:00:00","108000","1091200","1199200","46575000","144478500","191053500"
"801","32270","18003111","01- Annual","2016-01-01T00:00:00","108000","1107200","1215200","46575000","153457400","200032400"
"802","32270","18003111","03- Board of Equalization","2015-09-28T00:00:00","201600","1022216","1223816","44275000","148228584","192503584"
"803","32270","18003111","01- Annual","2017-01-01T00:00:00","108000","1144600","1252600","49450000","147205600","196655600"
"804","32270","18003111","01- Annual","2015-01-01T00:00:00","108000","1135100","1243100","44275000","165571500","209846500"
"805","32270","18003111","03- Board of Equalization","2013-09-26T00:00:00","108000","940800","1048800","40250000","154350200","194600200"
"806","32270","18003111","01- Annual","2014-01-01T00:00:00","108000","1140600","1248600","40250000","158869400","199119400"
"807","32675","18003602","01- Annual","2014-01-01T00:00:00","144000","1096800","1240800","33840000","177155900","210995900"
"808","32675","18003602","01- Annual","2015-01-01T00:00:00","144000","1385500","1529500","43428000","172222700","215650700"
"809","32675","18003602","01- Annual","2017-01-01T00:00:00","144000","1402700","1546700","48504000","162008200","210512200"
"810","32675","18003602","03- Board of Equalization","2015-11-03T00:00:00","144000","1347300","1491300","43428000","164129700","207557700"
"811","32675","18003602","01- Annual","2016-01-01T00:00:00","144000","1386100","1530100","45684000","163922600","209606600"
"812","32675","18003602","01- Annual","2018-01-01T00:00:00","144000","1100200","1244200","48504000","155261900","203765900"
"813","32675","18003602","","2011-01-01T00:00:00","132000","892300","1024300","33840000","124871800","158711800"
"814","32675","18003602","","2012-01-01T00:00:00","144000","1055900","1199900","33840000","164881700","198721700"
"815","32675","18003602","","2010-09-01T00:00:00","115200","901700","1016900","31584000","120949500","152533500"
"816","32675","18003602","","2010-01-01T00:00:00","115200","801900","917100","31584000","130646300","162230300"
"817","32675","18003602","","2009-01-01T00:00:00","144000","807000","951000","37224000","123664900","160888900"
"818","32675","18003602","","2008-01-01T00:00:00","144000","859200","1003200","37224000","132412500","169636500"
"819","32675","18003602","01- Annual","2013-01-01T00:00:00","144000","1084400","1228400","33840000","171758300","205598300"
"820","32685","18004066","01- Annual","2013-01-01T00:00:00","613600","6398100","7011700","17478600","102251700","119730300"
"821","32685","18004066","","2008-01-01T00:00:00","613600","4686800","5300400","16479800","76447000","92926800"
"822","32685","18004066","","2009-01-01T00:00:00","613600","4460400","5074000","16479800","76430000","92909800"
"823","32685","18004066","","2010-01-01T00:00:00","490900","4426000","4916900","13982900","69918400","83901300"
"824","32685","18004066","","2012-01-01T00:00:00","613600","6010200","6623800","14981600","101700300","116681900"
"825","32685","18004066","","2011-01-01T00:00:00","562400","5457100","6019500","14981600","82306700","97288300"
"826","32685","18004066","05- Review","2015-12-13T00:00:00","576800","6074100","6650900","18072800","100042100","118114900"
"827","32685","18004066","05- Review","2014-12-13T00:00:00","589100","6449900","7039000","16779500","101366300","118145800"
"828","32685","18004066","01- Annual","2018-01-01T00:00:00","376300","0","376300","13169700","0","13169700"
"829","32685","18004066","03- Board of Equalization","2016-10-04T00:00:00","564512","6030140","6594652","18607184","101249128","119856312"
"830","32685","18004066","05- Review","2013-12-13T00:00:00","601300","6270100","6871400","17129000","100206700","117335700"
"831","32685","18004066","01- Annual","2017-01-01T00:00:00","552200","6953700","7505900","19326300","101555600","120881900"
"832","32685","18004066","01- Annual","2016-01-01T00:00:00","613600","6554500","7168100","20225200","110146000","130371200"
"833","32685","18004066","03- Board of Equalization","2014-10-13T00:00:00","613600","6718600","7332200","17478600","105589900","123068500"
"834","32685","18004066","01- Annual","2015-01-01T00:00:00","613600","6461800","7075400","19226400","106427800","125654200"
"835","32685","18004066","01- Annual","2014-01-01T00:00:00","613600","6718600","7332200","17478600","107478300","124956900"
"836","32691","18005040","01- Annual","2014-01-01T00:00:00","359500","0","359500","10241400","0","10241400"
"837","32691","18005040","01- Annual","2015-01-01T00:00:00","359500","0","359500","11265600","0","11265600"
"838","32691","18005040","01- Annual","2016-01-01T00:00:00","359500","0","359500","11850800","0","11850800"
"839","32691","18005040","01- Annual","2017-01-01T00:00:00","323600","0","323600","11324100","0","11324100"
"840","32691","18005040","05- Review","2015-12-13T00:00:00","337900","0","337900","10589700","0","10589700"
"841","32691","18005040","03- Board of Equalization","2016-10-04T00:00:00","330700","0","330700","10902736","0","10902736"
"842","32691","18005040","01- Annual","2018-01-01T00:00:00","220500","0","220500","7716600","0","7716600"
"843","32691","18005040","05- Review","2013-12-13T00:00:00","352300","0","352300","10036600","0","10036600"
"844","32691","18005040","05- Review","2014-12-13T00:00:00","345100","0","345100","9831700","0","9831700"
"845","32691","18005040","","2011-01-01T00:00:00","329600","0","329600","8778400","0","8778400"
"846","32691","18005040","","2012-01-01T00:00:00","359500","0","359500","8778400","0","8778400"
"847","32691","18005040","","2010-01-01T00:00:00","287600","0","287600","8193100","0","8193100"
"848","32691","18005040","","2009-01-01T00:00:00","359500","0","359500","9656200","0","9656200"
"849","32691","18005040","","2008-01-01T00:00:00","359500","0","359500","9656200","0","9656200"
"850","32691","18005040","01- Annual","2013-01-01T00:00:00","359500","0","359500","10241400","0","10241400"
"851","32889","18007031","05- Review","2013-08-16T00:00:00","75000","101700","176700","18550000","56453900","75003900"
"852","32889","18007031","01- Annual","2013-01-01T00:00:00","75000","101700","176700","18550000","56476800","75026800"
"853","32889","18007031","","2008-01-01T00:00:00","75000","88900","163900","17424000","37541100","54965100"
"854","32889","18007031","","2009-01-01T00:00:00","75000","73200","148200","17424000","32353700","49777700"
"855","32889","18007031","","2010-01-01T00:00:00","60000","78500","138500","14784000","36674100","51458100"
"856","32889","18007031","","2012-01-01T00:00:00","75000","86000","161000","15840000","55682300","71522300"
"857","32889","18007031","","2011-01-01T00:00:00","68800","81400","150200","15840000","42410800","58250800"
"858","32940","18013001","","2008-01-01T00:00:00","988300","0","988300","1643600","0","1643600"
"859","32941","18013003","","2008-01-01T00:00:00","2854700","1000","2855700","4747500","0","4747500"
"860","32942","18013004","","2008-01-01T00:00:00","974900","0","974900","1621200","0","1621200"
"861","32943","18013005","","2008-01-01T00:00:00","1577200","0","1577200","2622900","0","2622900"
"862","32944","18013006","","2008-01-01T00:00:00","880300","0","880300","1463900","0","1463900"
"863","32945","18013007","","2008-01-01T00:00:00","69000","0","69000","114800","0","114800"
"864","32946","18013008","","2008-01-01T00:00:00","356000","0","356000","592000","0","592000"
"865","32947","18013009","","2008-01-01T00:00:00","245100","0","245100","407600","0","407600"
"866","32948","18013010","","2008-01-01T00:00:00","1738100","1606000","3344100","2890500","0","2890500"
"867","33220","18029007","","2008-01-01T00:00:00","1490500","1000","1491500","9834000","0","9834000"
"868","33220","18029007","","2009-01-01T00:00:00","1490500","1000","1491500","9834000","0","9834000"
"869","33220","18029007","01- Annual","2013-01-01T00:00:00","1245400","7393500","8638900","9120000","46910900","56030900"
"870","33220","18029007","","2011-01-01T00:00:00","1366300","1000","1367300","8940000","0","8940000"
"871","33220","18029007","","2012-01-01T00:00:00","1490500","10673100","12163600","8940000","0","8940000"
"872","33220","18029007","","2010-01-01T00:00:00","1192400","1000","1193400","8344000","0","8344000"
"873","33220","18029007","01- Annual","2018-01-01T00:00:00","1245400","11078000","12323400","9120000","56373200","65493200"
"874","33220","18029007","01- Annual","2017-01-01T00:00:00","1245400","11763500","13008900","11248000","53728300","64976300"
"875","33220","18029007","01- Annual","2016-01-01T00:00:00","1245400","9121200","10366600","10640000","52946000","63586000"
"876","33220","18029007","01- Annual","2015-01-01T00:00:00","1245400","7716800","8962200","10032000","52927900","62959900"
"877","33220","18029007","01- Annual","2014-01-01T00:00:00","1245400","7783800","9029200","9120000","48202500","57322500"
"878","33352","18038019","","2010-01-01T00:00:00","918300","0","918300","6013100","0","6013100"
"879","33352","18038019","","2012-01-01T00:00:00","956600","0","956600","6442600","1983700","8426300"
"880","33352","18038019","","2011-01-01T00:00:00","880000","67000","947000","5905700","188000","6093700"
"881","33353","18038020","","2011-01-01T00:00:00","333600","0","333600","2238800","0","2238800"
"882","33353","18038020","","2012-01-01T00:00:00","362600","0","362600","2442300","3255800","5698100"
"883","33353","18038020","","2010-01-01T00:00:00","348100","0","348100","2279500","0","2279500"
"884","33356","18038023","","2010-01-01T00:00:00","341400","0","341400","2235400","0","2235400"
"885","33356","18038023","","2012-01-01T00:00:00","355600","0","355600","2395100","0","2395100"
"886","33356","18038023","","2011-01-01T00:00:00","327200","0","327200","2195500","0","2195500"
"887","33424","18041002","","2011-01-01T00:00:00","11000","841100","852100","220000","199100","419100"
"888","33424","18041002","","2012-01-01T00:00:00","11000","896100","907100","240000","225500","465500"
"889","33424","18041002","","2010-01-01T00:00:00","11000","836200","847200","224000","140300","364300"
"890","33424","18041002","01- Annual","2013-01-01T00:00:00","11000","896100","907100","240000","210000","450000"
"891","33424","18041002","","2009-01-01T00:00:00","11000","927100","938100","264000","137900","401900"
"892","33424","18041002","","2008-01-01T00:00:00","11000","903500","914500","264000","95300","359300"
"893","33424","18041002","01- Annual","2014-01-01T00:00:00","11000","877600","888600","240000","307900","547900"
"894","33424","18041002","01- Annual","2015-01-01T00:00:00","251500","637100","888600","0","633800","633800"
"895","33610","18054007","01- Annual","2016-01-01T00:00:00","137500","76100","213600","631800","1483600","2115400"
"896","33610","18054007","01- Annual","2014-01-01T00:00:00","137500","49500","187000","546000","1163600","1709600"
"897","33610","18054007","01- Annual","2015-01-01T00:00:00","137500","76400","213900","600600","1518000","2118600"
"898","33610","18054007","01- Annual","2018-01-01T00:00:00","144400","132200","276600","663400","1891700","2555100"
"899","33610","18054007","","2008-01-01T00:00:00","165000","74600","239600","514800","1077200","1592000"
"900","33610","18054007","","2009-01-01T00:00:00","165000","50100","215100","514800","914300","1429100"
"901","33610","18054007","05- Review","2013-08-21T00:00:00","137500","49500","187000","546000","1191800","1737800"
"902","33610","18054007","01- Annual","2013-01-01T00:00:00","137500","127900","265400","546000","1457700","2003700"
"903","33610","18054007","","2008-11-01T00:00:00","165000","74600","239600","514800","954500","1469300"
"904","33610","18054007","","2010-01-01T00:00:00","132000","64300","196300","514800","900000","1414800"
"905","33610","18054007","","2012-01-01T00:00:00","137500","89700","227200","546000","1091300","1637300"
"906","33610","18054007","","2011-01-01T00:00:00","126500","90600","217100","514800","1049900","1564700"
"907","33614","18054011","","2011-01-01T00:00:00","15000","319300","334300","198000","325900","523900"
"908","33614","18054011","","2012-01-01T00:00:00","15000","340900","355900","198000","383800","581800"
"909","33614","18054011","","2010-01-01T00:00:00","15000","317400","332400","198000","248000","446000"
"910","33614","18054011","01- Annual","2013-01-01T00:00:00","15000","351300","366300","198000","374000","572000"
"911","33614","18054011","","2009-01-01T00:00:00","15000","345500","360500","198000","330600","528600"
"912","33614","18054011","","2008-01-01T00:00:00","15000","338200","353200","198000","71400","269400"
"913","33614","18054011","01- Annual","2015-01-01T00:00:00","213100","554800","767900","0","539400","539400"
"914","33614","18054011","01- Annual","2014-01-01T00:00:00","152200","527900","680100","198000","316300","514300"
"915","33616","18054013","01- Annual","2014-01-01T00:00:00","294000","287800","581800","240000","261200","501200"
"916","33616","18054013","01- Annual","2015-01-01T00:00:00","534000","518000","1052000","0","600300","600300"
"917","33616","18054013","","2008-01-01T00:00:00","270000","421500","691500","264000","95300","359300"
"918","33616","18054013","","2009-01-01T00:00:00","270000","397600","667600","264000","171000","435000"
"919","33616","18054013","01- Annual","2013-01-01T00:00:00","294000","262600","556600","240000","171600","411600"
"920","33616","18054013","","2010-01-01T00:00:00","310000","313700","623700","224000","115800","339800"
"921","33616","18054013","","2012-01-01T00:00:00","294000","333300","627300","240000","174700","414700"
"922","33616","18054013","","2011-01-01T00:00:00","314000","313300","627300","220000","180100","400100"
"923","34352","18084003","","2011-01-01T00:00:00","298900","93400","392300","12840000","9146400","21986400"
"924","34352","18084003","","2012-01-01T00:00:00","326100","77100","403200","14980000","12957900","27937900"
"925","34352","18084003","","2010-01-01T00:00:00","260900","101900","362800","11984000","7566600","19550600"
"926","34352","18084003","01- Annual","2013-01-01T00:00:00","326100","48700","374800","14980000","11005100","25985100"
"927","34352","18084003","","2009-01-01T00:00:00","326100","169600","495700","14124000","14862400","28986400"
"928","34352","18084003","","2008-01-01T00:00:00","326100","190200","516300","14124000","16076200","30200200"
"929","34352","18084003","01- Annual","2016-01-01T00:00:00","326100","157800","483900","17334000","8598700","25932700"
"930","34352","18084003","01- Annual","2017-01-01T00:00:00","326100","212000","538100","18404000","10234700","28638700"
"931","34352","18084003","01- Annual","2014-01-01T00:00:00","326100","184100","510200","14980000","9355100","24335100"
"932","34352","18084003","01- Annual","2015-01-01T00:00:00","326100","168300","494400","16478000","8754000","25232000"
"933","34352","18084003","01- Annual","2018-01-01T00:00:00","326100","613100","939200","18404000","15310500","33714500"
"934","34490","19007002","01- Annual","2017-01-01T00:00:00","70100","60500","130600","1729600","930700","2660300"
"935","34491","19007003","01- Annual","2017-01-01T00:00:00","114100","99400","213500","2815600","1529000","4344600"
"936","34492","19007004","01- Annual","2017-01-01T00:00:00","74400","64800","139200","1836400","997200","2833600"
"937","34493","19007005","01- Annual","2017-01-01T00:00:00","60800","51900","112700","1500500","797700","2298200"
"938","34494","19007006","01- Annual","2017-01-01T00:00:00","60800","51900","112700","1500500","797700","2298200"
"939","34495","19007007","01- Annual","2017-01-01T00:00:00","60800","51900","112700","1500800","797700","2298500"
"940","34496","19007008","01- Annual","2017-01-01T00:00:00","60800","51900","112700","1500500","797700","2298200"
"941","35975","20012359","01- Annual","2015-01-01T00:00:00","132200","793600","925800","12551000","39268400","51819400"
"943","40065","23034017","01- Annual","2017-01-01T00:00:00","1912300","1000","1913300","11518700","0","11518700"
"944","40065","23034017","05- Review","2017-04-03T00:00:00","1912300","1000","1913300","10022900","0","10022900"
"945","40065","23034017","01- Annual","2018-01-01T00:00:00","1738500","1000","1739500","9339500","0","9339500"
"946","40066","23034018","01- Annual","2018-01-01T00:00:00","2218800","1000","2219800","11919900","0","11919900"
"947","40066","23034018","05- Review","2017-04-03T00:00:00","2440700","1000","2441700","12792000","0","12792000"
"948","40066","23034018","01- Annual","2017-01-01T00:00:00","2440700","1000","2441700","14701200","0","14701200"
"949","40067","23034019","01- Annual","2017-01-01T00:00:00","131200","0","131200","790100","0","790100"
"950","40067","23034019","05- Review","2017-04-03T00:00:00","131200","0","131200","687500","0","687500"
"951","40067","23034019","01- Annual","2018-01-01T00:00:00","119300","0","119300","640600","0","640600"
"952","40415","23040008","01- Annual","2017-01-01T00:00:00","63500","0","63500","1827300","0","1827300"
"953","40416","23040009","01- Annual","2017-01-01T00:00:00","381500","0","381500","10974700","1000","10975700"
"954","40994","24015015","01- Annual","2017-01-01T00:00:00","588000","2175600","2763600","12956300","14309000","27265300"
"955","40994","24015015","01- Annual","2018-01-01T00:00:00","588000","3005200","3593200","10505100","19253000","29758100"
"956","40994","24015015","01- Annual","2015-01-01T00:00:00","588000","2126300","2714300","11555600","14651900","26207500"
"957","40994","24015015","01- Annual","2014-01-01T00:00:00","705600","1909300","2614900","12255900","11017600","23273500"
"958","40994","24015015","01- Annual","2016-01-01T00:00:00","588000","2096700","2684700","12255900","13799100","26055000"
"959","40994","24015015","01- Annual","2013-01-01T00:00:00","705600","1250100","1955700","12255900","9414000","21669900"
"960","40994","24015015","","2010-01-01T00:00:00","0","838200","838200","10528000","6854400","17382400"
"961","40994","24015015","","2012-01-01T00:00:00","0","1136500","1136500","13160000","7018000","20178000"
"962","40994","24015015","","2011-01-01T00:00:00","0","767000","767000","11280000","6470600","17750600"
"963","40995","24015017","","2011-01-01T00:00:00","694500","0","694500","0","0","0"
"964","40995","24015017","","2012-01-01T00:00:00","757600","0","757600","0","0","0"
"965","40995","24015017","","2010-01-01T00:00:00","606100","0","606100","0","0","0"
"966","40995","24015017","01- Annual","2016-01-01T00:00:00","43400","0","43400","904100","0","904100"
"967","40995","24015017","01- Annual","2014-01-01T00:00:00","41900","0","41900","169964800","0","169964800"
"968","40995","24015017","01- Annual","2013-01-01T00:00:00","52000","0","52000","904100","0","904100"
"969","40995","24015017","01- Annual","2015-01-01T00:00:00","43400","0","43400","852400","0","852400"
"970","40995","24015017","01- Annual","2018-01-01T00:00:00","43400","0","43400","774900","0","774900"
"971","40995","24015017","01- Annual","2017-01-01T00:00:00","43400","0","43400","955700","0","955700"
"972","42114","25016006","","2008-01-01T00:00:00","2280900","0","2280900","7730600","0","7730600"
"973","42114","25016006","","2009-01-01T00:00:00","2280900","0","2280900","7730600","0","7730600"
"974","42115","25016009","","2009-01-01T00:00:00","3357400","1000","3358400","11379000","0","11379000"
"975","42115","25016009","","2008-01-01T00:00:00","3357400","1000","3358400","11379000","0","11379000"
"976","42117","25016011","","2008-01-01T00:00:00","184300","0","184300","624500","0","624500"
"977","42117","25016011","","2009-01-01T00:00:00","184300","0","184300","624500","0","624500"
"978","43303","27002001","05- Review","2013-08-30T00:00:00","0","0","0","31869700","1412600","33282300"
"979","43303","27002001","","2008-01-01T00:00:00","0","0","0","29831100","3187500","33018600"
"980","43303","27002001","01- Annual","2013-01-01T00:00:00","0","0","0","31869700","2588900","34458600"
"981","43303","27002001","","2010-01-01T00:00:00","0","0","0","25324700","424700","25749400"
"982","43303","27002001","","2012-01-01T00:00:00","0","0","0","31869700","424700","32294400"
"983","43303","27002001","","2011-01-01T00:00:00","0","0","0","25326000","424700","25750700"
"984","43303","27002001","01- Annual","2017-01-01T00:00:00","0","0","0","38384400","982300","39366700"
"985","43303","27002001","01- Annual","2018-01-01T00:00:00","0","0","0","38384400","8910500","47294900"
"986","43303","27002001","01- Annual","2015-01-01T00:00:00","0","0","0","34894900","3677400","38572300"
"987","43303","27002001","01- Annual","2014-01-01T00:00:00","0","0","0","31869700","5541800","37411500"
"988","43303","27002001","01- Annual","2016-01-01T00:00:00","33100","0","33100","36556600","1972200","38528800"
"989","43306","27002004","01- Annual","2016-01-01T00:00:00","4400","76000","80400","4888400","265900","5154300"
"990","43306","27002004","01- Annual","2014-01-01T00:00:00","100000","92800","192800","4272900","747200","5020100"
"991","43306","27002004","01- Annual","2015-01-01T00:00:00","100000","81600","181600","4666200","495900","5162100"
"992","43306","27002004","01- Annual","2018-01-01T00:00:00","0","345600","345600","5132800","1201600","6334400"
"993","43306","27002004","01- Annual","2017-01-01T00:00:00","0","186400","186400","5132800","132500","5265300"
"994","43306","27002004","","2011-01-01T00:00:00","92000","75900","167900","3395600","53100","3448700"
"995","43306","27002004","","2012-01-01T00:00:00","100000","65900","165900","4272900","53100","4326000"
"996","43306","27002004","","2010-01-01T00:00:00","96000","58800","154800","3395400","53100","3448500"
"997","43306","27002004","01- Annual","2013-01-01T00:00:00","100000","67600","167600","4272900","349100","4622000"
"998","43306","27002004","05- Review","2013-08-30T00:00:00","100000","71800","171800","4272900","190500","4463400"
"999","43306","27002004","","2009-01-01T00:00:00","120000","63500","183500","3999600","53100","4052700"
"1000","43306","27002004","","2008-01-01T00:00:00","120000","70500","190500","3999600","390000","4389600"
"1001","43307","27002005","","2009-01-01T00:00:00","0","0","0","14241200","212300","14453500"
"1002","43307","27002005","05- Review","2013-08-30T00:00:00","0","0","0","15214500","674200","15888700"
"1003","43307","27002005","01- Annual","2013-01-01T00:00:00","0","0","0","15214500","1235600","16450100"
"1004","43307","27002005","","2010-01-01T00:00:00","0","0","0","12089900","212300","12302200"
"1005","43307","27002005","","2012-01-01T00:00:00","0","0","0","15214500","212300","15426800"
"1006","43307","27002005","","2011-01-01T00:00:00","0","0","0","12090600","212300","12302900"
"1007","43307","27002005","01- Annual","2017-01-01T00:00:00","0","0","0","18276300","468800","18745100"
"1008","43307","27002005","01- Annual","2018-01-01T00:00:00","0","0","0","18276300","4252700","22529000"
"1009","43307","27002005","01- Annual","2015-01-01T00:00:00","0","0","0","16614800","1755000","18369800"
"1010","43307","27002005","01- Annual","2014-01-01T00:00:00","0","0","0","15214500","2644800","17859300"
"1011","43307","27002005","01- Annual","2016-01-01T00:00:00","15800","0","15800","17406000","941300","18347300"
"1012","43308","27002006","01- Annual","2016-01-01T00:00:00","14600","0","14600","16118700","872500","16991200"
"1013","43308","27002006","01- Annual","2014-01-01T00:00:00","0","0","0","14089300","2451700","16541000"
"1014","43308","27002006","01- Annual","2015-01-01T00:00:00","0","0","0","15386100","1626900","17013000"
"1015","43308","27002006","01- Annual","2018-01-01T00:00:00","0","0","0","16924700","3942200","20866900"
"1016","43308","27002006","01- Annual","2017-01-01T00:00:00","0","0","0","16924700","434600","17359300"
"1017","43308","27002006","","2011-01-01T00:00:00","0","0","0","11196400","199100","11395500"
"1018","43308","27002006","","2012-01-01T00:00:00","0","0","0","14089300","199100","14288400"
"1019","43308","27002006","","2010-01-01T00:00:00","0","0","0","11195800","199100","11394900"
"1020","43308","27002006","05- Review","2013-08-30T00:00:00","0","0","0","14089300","625000","14714300"
"1021","43308","27002006","01- Annual","2013-01-01T00:00:00","0","0","0","14089300","1145400","15234700"
"1022","43308","27002006","","2009-01-01T00:00:00","0","0","0","13188100","199100","13387200"
"1023","43309","27002010","","2009-01-01T00:00:00","0","0","0","10491000","159200","10650200"
"1024","43309","27002010","01- Annual","2013-01-01T00:00:00","0","0","0","11207900","910000","12117900"
"1025","43309","27002010","05- Review","2013-08-30T00:00:00","0","0","0","11207900","496500","11704400"
"1026","43309","27002010","","2010-01-01T00:00:00","0","0","0","8906200","159200","9065400"
"1027","43309","27002010","","2012-01-01T00:00:00","0","0","0","11207900","159200","11367100"
"1028","43309","27002010","","2011-01-01T00:00:00","0","0","0","8906600","159200","9065800"
"1029","43309","27002010","01- Annual","2017-01-01T00:00:00","0","0","0","13348800","345300","13694100"
"1030","43309","27002010","01- Annual","2018-01-01T00:00:00","0","0","0","13348800","3132200","16481000"
"1031","43309","27002010","01- Annual","2015-01-01T00:00:00","0","0","0","12135200","1292600","13427800"
"1032","43309","27002010","01- Annual","2014-01-01T00:00:00","0","0","0","11207900","1947900","13155800"
"1033","43309","27002010","01- Annual","2016-01-01T00:00:00","11500","0","11500","12713100","693300","13406400"
"1034","43310","27003001","01- Annual","2016-01-01T00:00:00","8700","0","8700","9613400","519900","10133300"
"1035","43310","27003001","01- Annual","2014-01-01T00:00:00","0","0","0","8406800","1460900","9867700"
"1036","43310","27003001","01- Annual","2015-01-01T00:00:00","0","0","0","9176500","969400","10145900"
"1037","43310","27003001","01- Annual","2018-01-01T00:00:00","0","0","0","10094100","2349100","12443200"
"1038","43310","27003001","01- Annual","2017-01-01T00:00:00","0","0","0","10094100","259000","10353100"
"1039","43310","27003001","","2011-01-01T00:00:00","0","0","0","6680700","119400","6800100"
"1040","43310","27003001","","2012-01-01T00:00:00","0","0","0","8406800","119400","8526200"
"1041","43310","27003001","","2010-01-01T00:00:00","0","0","0","6680300","119400","6799700"
"1042","43310","27003001","05- Review","2013-08-30T00:00:00","0","0","0","8406800","372400","8779200"
"1043","43310","27003001","01- Annual","2013-01-01T00:00:00","0","0","0","8406800","682500","9089300"
"1044","43310","27003001","","2009-01-01T00:00:00","0","0","0","7869000","119400","7988400"
"1045","43313","27004003","","2009-01-01T00:00:00","0","0","0","2906100","39800","2945900"
"1046","43313","27004003","01- Annual","2013-01-01T00:00:00","0","0","0","3104700","251100","3355800"
"1047","43313","27004003","05- Review","2013-08-30T00:00:00","0","0","0","3104700","136900","3241600"
"1048","43313","27004003","","2010-01-01T00:00:00","0","0","0","2467100","39800","2506900"
"1049","43313","27004003","","2012-01-01T00:00:00","0","0","0","3104700","39800","3144500"
"1050","43313","27004003","","2011-01-01T00:00:00","0","0","0","2467200","39800","2507000"
"1051","43313","27004003","01- Annual","2017-01-01T00:00:00","0","0","0","3740800","95300","3836100"
"1052","43313","27004003","01- Annual","2018-01-01T00:00:00","0","0","0","3740800","864000","4604800"
"1053","43313","27004003","01- Annual","2015-01-01T00:00:00","0","0","0","3400700","356700","3757400"
"1054","43313","27004003","01- Annual","2014-01-01T00:00:00","0","0","0","3104700","537500","3642200"
"1055","43313","27004003","01- Annual","2016-01-01T00:00:00","3200","0","3200","3562600","191200","3753800"
"1056","43385","27007077","01- Annual","2016-01-01T00:00:00","8700","0","8700","9607800","519900","10127700"
"1057","43385","27007077","01- Annual","2014-01-01T00:00:00","0","0","0","8418500","1460900","9879400"
"1058","43385","27007077","01- Annual","2015-01-01T00:00:00","0","0","0","9171100","969400","10140500"
"1059","43385","27007077","01- Annual","2018-01-01T00:00:00","0","0","0","10088200","2349100","12437300"
"1060","43385","27007077","01- Annual","2017-01-01T00:00:00","0","0","0","10088200","259000","10347200"
"1061","43385","27007077","","2011-01-01T00:00:00","0","0","0","6690000","119400","6809400"
"1062","43385","27007077","","2012-01-01T00:00:00","0","0","0","8418500","119400","8537900"
"1063","43385","27007077","","2010-01-01T00:00:00","0","0","0","6689600","119400","6809000"
"1064","43385","27007077","05- Review","2013-08-30T00:00:00","0","0","0","8418500","372400","8790900"
"1065","43385","27007077","01- Annual","2013-01-01T00:00:00","0","0","0","8418500","682500","9101000"
"1066","43385","27007077","","2009-01-01T00:00:00","0","0","0","7880000","119400","7999400"
"1067","44098","28004003","","2009-01-01T00:00:00","109500","210100","319600","26400000","50073700","76473700"
"1068","44098","28004003","","2008-01-01T00:00:00","109500","191000","300500","26400000","45637900","72037900"
"1069","44098","28004003","05- Review","2013-07-30T00:00:00","91300","184200","275500","24000000","59087700","83087700"
"1070","44098","28004003","01- Annual","2013-01-01T00:00:00","91300","184200","275500","24000000","59146500","83146500"
"1071","44098","28004003","","2010-01-01T00:00:00","87600","174400","262000","22400000","43615100","66015100"
"1072","44098","28004003","","2012-01-01T00:00:00","91300","177100","268400","24000000","54965600","78965600"
"1073","44098","28004003","","2011-01-01T00:00:00","84000","200100","284100","22000000","53775000","75775000"
"1074","44098","28004003","03- Board of Equalization","2016-09-07T00:00:00","91300","230700","322000","28000000","60082200","88082200"
"1075","44098","28004003","03- Board of Equalization","2017-08-31T00:00:00","91300","267900","359200","29600000","58445000","88045000"
"1076","44098","28004003","01- Annual","2018-01-01T00:00:00","91300","299700","391000","24000000","66490000","90490000"
"1077","44098","28004003","01- Annual","2015-01-01T00:00:00","91300","233800","325100","26400000","67253200","93653200"
"1078","44098","28004003","01- Annual","2014-01-01T00:00:00","91300","199400","290700","24000000","61259200","85259200"
"1079","44098","28004003","01- Annual","2017-01-01T00:00:00","91300","267900","359200","29600000","60227500","89827500"
"1080","44098","28004003","01- Annual","2016-01-01T00:00:00","91300","243300","334600","28000000","61426900","89426900"
"1081","44098","28004003","03- Board of Equalization","2015-08-31T00:00:00","91300","239200","330500","26400000","61348700","87748700"
"1082","44099","28004004","","2008-01-01T00:00:00","227500","0","227500","7797700","0","7797700"
"1083","44099","28004004","","2009-01-01T00:00:00","227500","0","227500","7797700","10280900","18078600"
"1084","44100","28004005","","2009-01-01T00:00:00","225100","0","225100","7712300","10280900","17993200"
"1085","44100","28004005","","2008-01-01T00:00:00","225100","0","225100","7712300","0","7712300"
"1086","44711","28018001","","2008-01-01T00:00:00","180000","128800","308800","6336000","6594500","12930500"
"1087","44711","28018001","","2009-01-01T00:00:00","180000","116400","296400","6336000","6077200","12413200"
"1088","44711","28018001","01- Annual","2013-01-01T00:00:00","150000","146100","296100","6000000","13323400","19323400"
"1089","44711","28018001","","2011-01-01T00:00:00","138000","80900","218900","5280000","7284300","12564300"
"1090","44711","28018001","","2012-01-01T00:00:00","150000","120000","270000","6000000","11470800","17470800"
"1091","44711","28018001","","2010-01-01T00:00:00","144000","56300","200300","5376000","6120800","11496800"
"1092","44711","28018001","01- Annual","2015-01-01T00:00:00","150000","835500","985500","6600000","14456900","21056900"
"1093","44711","28018001","01- Annual","2016-01-01T00:00:00","150000","752100","902100","7000000","12275900","19275900"
"1094","44711","28018001","01- Annual","2014-01-01T00:00:00","150000","182000","332000","6000000","15792400","21792400"
"1095","44711","28018001","01- Annual","2017-01-01T00:00:00","150000","682100","832100","7400000","11826400","19226400"
"1096","45694","29003010","01- Annual","2017-01-01T00:00:00","49800","147600","197400","30651700","46895000","77546700"
"1097","45694","29003010","01- Annual","2018-01-01T00:00:00","49800","0","49800","24852800","0","24852800"
"1098","45694","29003010","01- Annual","2014-01-01T00:00:00","49800","133800","183600","22781700","51909000","74690700"
"1099","45694","29003010","01- Annual","2015-01-01T00:00:00","49800","150400","200200","27338000","54986200","82324200"
"1100","45694","29003010","01- Annual","2016-01-01T00:00:00","49800","143500","193300","28994900","50464600","79459500"
"1101","45694","29003010","05- Review","2016-08-15T00:00:00","49800","145400","195200","28994900","47791100","76786000"
"1102","45694","29003010","05- Review","2015-06-26T00:00:00","49800","141200","191000","27275500","50552200","77827700"
"1103","45694","29003010","","2010-01-01T00:00:00","47800","116700","164500","23195900","29731900","52927800"
"1104","45694","29003010","","2012-05-01T00:00:00","49800","124200","174000","22781700","46702600","69484300"
"1105","45694","29003010","","2012-01-01T00:00:00","49800","129800","179600","22781700","53431700","76213400"
"1106","45694","29003010","","2011-01-01T00:00:00","45800","111700","157500","22781700","36160700","58942400"
"1107","45694","29003010","01- Annual","2013-01-01T00:00:00","49800","128900","178700","22781700","47813300","70595000"
"1108","45694","29003010","","2009-01-01T00:00:00","59700","112200","171900","27338000","30852700","58190700"
"1109","45694","29003010","","2008-01-01T00:00:00","59700","96600","156300","27338000","35088200","62426200"
"1110","45695","29003019","","2008-01-01T00:00:00","3300","0","3300","1504000","0","1504000"
"1111","45695","29003019","","2009-01-01T00:00:00","3300","0","3300","1504000","0","1504000"
"1112","45695","29003019","01- Annual","2013-01-01T00:00:00","2700","0","2700","1253300","0","1253300"
"1113","45695","29003019","","2011-01-01T00:00:00","2500","0","2500","1253300","0","1253300"
"1114","45695","29003019","","2012-01-01T00:00:00","2700","0","2700","1253300","0","1253300"
"1115","45695","29003019","","2010-01-01T00:00:00","2600","0","2600","1276100","0","1276100"
"1116","45695","29003019","05- Review","2015-06-26T00:00:00","2700","0","2700","1500500","0","1500500"
"1117","45695","29003019","01- Annual","2016-01-01T00:00:00","2700","0","2700","1595100","0","1595100"
"1118","45695","29003019","01- Annual","2015-01-01T00:00:00","2700","0","2700","1504000","0","1504000"
"1119","45695","29003019","01- Annual","2014-01-01T00:00:00","2700","0","2700","519132500","0","519132500"
"1120","45695","29003019","01- Annual","2018-01-01T00:00:00","2700","0","2700","1367200","0","1367200"
"1121","45695","29003019","01- Annual","2017-01-01T00:00:00","2700","0","2700","1686300","0","1686300"
"1122","51204","31022003","","2008-01-01T00:00:00","12600","0","12600","198000","2000000","2198000"
"1123","51205","31022004","","2008-01-01T00:00:00","22100","0","22100","349200","0","349200"
"1124","51206","31022005","","2008-01-01T00:00:00","12200","0","12200","191800","0","191800"
"1125","51207","31022006","","2008-01-01T00:00:00","89000","0","89000","1403600","0","1403600"
"1126","51208","31022099","","2008-01-01T00:00:00","14200","0","14200","223400","0","223400"
"1127","51221","31024007","","2008-01-01T00:00:00","204500","113000","317500","132000","198100","330100"
"1128","51221","31024007","","2009-01-01T00:00:00","204500","125100","329600","132000","210400","342400"
"1129","51221","31024007","01- Annual","2013-01-01T00:00:00","216500","105500","322000","120000","258400","378400"
"1130","51221","31024007","","2010-01-01T00:00:00","224500","76200","300700","112000","176900","288900"
"1131","51221","31024007","","2012-01-01T00:00:00","216500","105500","322000","120000","244300","364300"
"1132","51221","31024007","","2011-01-01T00:00:00","226500","75900","302400","110000","223400","333400"
"1133","51221","31024007","01- Annual","2014-01-01T00:00:00","216500","126500","343000","240000","138400","378400"
"1134","51221","31024007","01- Annual","2015-01-01T00:00:00","336500","-2000","334500","0","440000","440000"
"1135","51294","31025049","","2010-01-01T00:00:00","56000","0","56000","2016000","0","2016000"
"1136","51294","31025049","","2010-11-01T00:00:00","0","0","0","0","0","0"
"1137","51331","31026001","","2009-08-01T00:00:00","14400","239000","253400","132000","19000","151000"
"1138","51331","31026001","","2010-01-01T00:00:00","75800","162000","237800","56000","29000","85000"
"1139","51331","31026001","","2011-01-01T00:00:00","76800","169600","246400","55000","45000","100000"
"1140","51331","31026001","","2012-01-01T00:00:00","71800","190500","262300","60000","51300","111300"
"1141","51331","31026001","01- Annual","2013-01-01T00:00:00","71800","202500","274300","60000","52200","112200"
"1142","51331","31026001","","2009-01-01T00:00:00","14400","239000","253400","132000","59300","191300"
"1143","51331","31026001","","2008-01-01T00:00:00","14400","171300","185700","132000","23400","155400"
"1144","51331","31026001","01- Annual","2014-01-01T00:00:00","175700","111500","287200","60000","191600","251600"
"1145","51331","31026001","03- Board of Equalization","2014-09-09T00:00:00","175700","88200","263900","60000","191600","251600"
"1146","51655","32001002","01- Annual","2014-01-01T00:00:00","100","134000","134100","2124369300","107223300","2231592600"
"1147","51655","32001002","01- Annual","2015-01-01T00:00:00","24500","143300","167800","12418900","114907600","127326500"
"1148","51655","32001002","03- Board of Equalization","2015-11-03T00:00:00","24500","138288","162788","12418900","111105012","123523912"
"1149","51655","32001002","01- Annual","2016-01-01T00:00:00","24700","144800","169500","13282700","112022700","125305400"
"1150","51655","32001002","03- Board of Equalization","2016-09-06T00:00:00","24700","144800","169500","13282700","111875200","125157900"
"1151","51655","32001002","01- Annual","2017-01-01T00:00:00","24500","145500","170000","21777400","109598700","131376100"
"1152","51655","32001002","01- Annual","2018-01-01T00:00:00","24500","0","24500","17657400","0","17657400"
"1153","51655","32001002","03- Board of Equalization","2017-10-31T00:00:00","24500","128800","153300","21777400","94390900","116168300"
"1154","51655","32001002","","2008-01-01T00:00:00","29400","182000","211400","12418900","72687300","85106200"
"1155","51655","32001002","","2009-01-01T00:00:00","29400","170300","199700","12418900","67902700","80321600"
"1156","51655","32001002","01- Annual","2013-01-01T00:00:00","24500","120700","145200","11289900","89562200","100852100"
"1157","51655","32001002","","2012-01-01T00:00:00","24500","118500","143000","11289900","77630800","88920700"
"1158","51655","32001002","","2011-01-01T00:00:00","22500","112000","134500","10349100","64857000","75206100"
"1159","51655","32001002","","2010-01-01T00:00:00","23500","78000","101500","10537300","49722100","60259400"
"1160","51656","32001003","","2010-01-01T00:00:00","2200","0","2200","1007200","0","1007200"
"1161","51656","32001003","","2011-01-01T00:00:00","2200","0","2200","989300","0","989300"
"1162","51656","32001003","","2012-01-01T00:00:00","2300","0","2300","1079200","0","1079200"
"1163","51656","32001003","01- Annual","2013-01-01T00:00:00","2300","0","2300","1079200","0","1079200"
"1164","51656","32001003","","2009-01-01T00:00:00","2800","0","2800","1187100","0","1187100"
"1165","51656","32001003","","2008-01-01T00:00:00","2800","0","2800","1187100","0","1187100"
"1166","51656","32001003","01- Annual","2018-01-01T00:00:00","2300","0","2300","1687900","0","1687900"
"1167","51656","32001003","01- Annual","2017-01-01T00:00:00","2300","0","2300","2081700","0","2081700"
"1168","51656","32001003","01- Annual","2016-01-01T00:00:00","2400","0","2400","1269700","0","1269700"
"1169","51656","32001003","01- Annual","2015-01-01T00:00:00","2300","0","2300","1187100","0","1187100"
"1170","51656","32001003","01- Annual","2014-01-01T00:00:00","0","0","0","203066300","0","203066300"
"1171","51658","32001005","01- Annual","2014-01-01T00:00:00","135000","174500","309500","19800000","31606800","51406800"
"1172","51658","32001005","01- Annual","2015-01-01T00:00:00","135000","156600","291600","21780000","31213300","52993300"
"1173","51658","32001005","03- Board of Equalization","2015-11-03T00:00:00","135000","146602","281602","21780000","29396298","51176298"
"1174","51658","32001005","01- Annual","2016-01-01T00:00:00","135000","143800","278800","23100000","28584300","51684300"
"1175","51658","32001005","01- Annual","2017-01-01T00:00:00","135000","162700","297700","24420000","34008700","58428700"
"1176","51658","32001005","01- Annual","2018-01-01T00:00:00","135000","269400","404400","19800000","42312300","62112300"
"1177","51658","32001005","","2008-01-01T00:00:00","162000","115900","277900","21846000","21690800","43536800"
"1178","51658","32001005","","2009-01-01T00:00:00","162000","71900","233900","21846000","19049800","40895800"
"1179","51658","32001005","05- Review","2013-10-23T00:00:00","135000","148700","283700","19800000","28239000","48039000"
"1180","51658","32001005","01- Annual","2013-01-01T00:00:00","135000","148700","283700","19800000","30827400","50627400"
"1181","51658","32001005","","2012-01-01T00:00:00","135000","145700","280700","19800000","28378000","48178000"
"1182","51658","32001005","","2011-01-01T00:00:00","124200","138300","262500","18205000","28622100","46827100"
"1183","51658","32001005","","2010-01-01T00:00:00","129600","114400","244000","18536000","24800400","43336400"
"1184","51658","32001005","","2010-10-01T00:00:00","129600","114400","244000","18480000","23685500","42165500"
"1185","51687","32001046","","2010-01-01T00:00:00","23200","0","23200","10418000","0","10418000"
"1186","51687","32001046","","2011-01-01T00:00:00","22300","0","22300","10232000","0","10232000"
"1187","51687","32001046","","2012-01-01T00:00:00","24200","0","24200","11162200","0","11162200"
"1188","51687","32001046","01- Annual","2013-01-01T00:00:00","24200","0","24200","11162200","0","11162200"
"1189","51687","32001046","","2009-01-01T00:00:00","29000","0","29000","12278400","0","12278400"
"1190","51687","32001046","","2008-01-01T00:00:00","29000","0","29000","12278400","0","12278400"
"1191","51687","32001046","01- Annual","2018-01-01T00:00:00","24200","0","24200","17457600","0","17457600"
"1192","51687","32001046","01- Annual","2017-01-01T00:00:00","24200","0","24200","21531000","0","21531000"
"1193","51687","32001046","01- Annual","2016-01-01T00:00:00","24400","0","24400","13132400","0","13132400"
"1194","51687","32001046","01- Annual","2015-01-01T00:00:00","24200","0","24200","12278400","0","12278400"
"1196","51687","32001046","01- Annual","2014-01-01T00:00:00","24200","0","24200","11162200","0","11162200"
"1197","51688","32001047","01- Annual","2014-01-01T00:00:00","0","0","0","64136300","0","64136300"
"1198","51688","32001047","01- Annual","2015-01-01T00:00:00","700","0","700","374900","0","374900"
"1199","51688","32001047","01- Annual","2016-01-01T00:00:00","700","0","700","401000","0","401000"
"1200","51688","32001047","01- Annual","2017-01-01T00:00:00","700","0","700","657500","0","657500"
"1201","51688","32001047","01- Annual","2018-01-01T00:00:00","700","0","700","533100","0","533100"
"1202","51688","32001047","03- Board of Equalization","2017-10-31T00:00:00","700","0","700","657600","0","657600"
"1203","51688","32001047","","2008-01-01T00:00:00","900","0","900","374900","0","374900"
"1204","51688","32001047","","2009-01-01T00:00:00","900","0","900","374900","0","374900"
"1205","51688","32001047","01- Annual","2013-01-01T00:00:00","700","0","700","340900","0","340900"
"1206","51688","32001047","","2012-01-01T00:00:00","700","0","700","340900","0","340900"
"1207","51688","32001047","","2011-01-01T00:00:00","700","0","700","312400","0","312400"
"1208","51688","32001047","","2010-01-01T00:00:00","700","0","700","318100","0","318100"
"1209","51689","32001048","","2010-01-01T00:00:00","24200","0","24200","10867900","0","10867900"
"1210","51689","32001048","","2011-01-01T00:00:00","23200","0","23200","10673800","0","10673800"
"1211","51689","32001048","","2012-01-01T00:00:00","25200","0","25200","11644200","0","11644200"
"1212","51689","32001048","01- Annual","2013-01-01T00:00:00","25200","0","25200","11644200","0","11644200"
"1213","51689","32001048","","2009-01-01T00:00:00","30300","0","30300","12808600","0","12808600"
"1214","51689","32001048","","2008-01-01T00:00:00","30300","0","30300","12808600","0","12808600"
"1215","51689","32001048","03- Board of Equalization","2017-10-31T00:00:00","25200","0","25200","22460800","0","22460800"
"1216","51689","32001048","01- Annual","2018-01-01T00:00:00","25200","0","25200","18211400","0","18211400"
"1217","51689","32001048","01- Annual","2017-01-01T00:00:00","25200","0","25200","22460700","0","22460700"
"1218","51689","32001048","01- Annual","2016-01-01T00:00:00","25400","0","25400","13699500","0","13699500"
"1219","51689","32001048","01- Annual","2015-01-01T00:00:00","25200","0","25200","12808600","0","12808600"
"1220","51689","32001048","01- Annual","2014-01-01T00:00:00","25200","0","25200","11644200","0","11644200"
"1221","51690","32001049","01- Annual","2014-01-01T00:00:00","0","0","0","1344191400","0","1344191400"
"1222","51690","32001049","01- Annual","2015-01-01T00:00:00","15500","0","15500","7858100","0","7858100"
"1223","51690","32001049","01- Annual","2016-01-01T00:00:00","15600","0","15600","8404600","0","8404600"
"1224","51690","32001049","01- Annual","2017-01-01T00:00:00","15500","0","15500","13779600","0","13779600"
"1225","51690","32001049","01- Annual","2018-01-01T00:00:00","15500","0","15500","11172700","0","11172700"
"1226","51690","32001049","","2008-01-01T00:00:00","18600","0","18600","7858100","0","7858100"
"1227","51690","32001049","","2009-01-01T00:00:00","18600","0","18600","7858100","0","7858100"
"1228","51690","32001049","01- Annual","2013-01-01T00:00:00","15500","0","15500","7143700","0","7143700"
"1229","51690","32001049","","2012-01-01T00:00:00","15500","0","15500","7143700","0","7143700"
"1230","51690","32001049","","2011-01-01T00:00:00","14300","0","14300","6548400","0","6548400"
"1231","51690","32001049","","2010-01-01T00:00:00","14900","0","14900","6667400","0","6667400"
"1232","52294","32003006","","2010-01-01T00:00:00","782500","505700","1288200","56000","42200","98200"
"1233","52294","32003006","","2011-01-01T00:00:00","783500","512100","1295600","55000","56900","111900"
"1234","52294","32003006","","2012-01-01T00:00:00","778500","600700","1379200","60000","61400","121400"
"1235","52294","32003006","01- Annual","2013-01-01T00:00:00","778500","604400","1382900","60000","61100","121100"
"1236","52294","32003006","","2009-01-01T00:00:00","920500","589800","1510300","66000","50400","116400"
"1237","52294","32003006","","2008-01-01T00:00:00","920500","569300","1489800","66000","40800","106800"
"1238","52294","32003006","01- Annual","2015-01-01T00:00:00","838500","641300","1479800","0","195000","195000"
"1239","52294","32003006","01- Annual","2014-01-01T00:00:00","778500","669100","1447600","60000","93900","153900"
"1240","52342","32006008","01- Annual","2014-01-01T00:00:00","433200","811100","1244300","240000","385700","625700"
"1241","52342","32006008","01- Annual","2015-01-01T00:00:00","673200","571100","1244300","0","627700","627700"
"1242","52342","32006008","","2008-01-01T00:00:00","528000","651500","1179500","264000","124400","388400"
"1243","52342","32006008","","2009-01-01T00:00:00","528000","674100","1202100","264000","149800","413800"
"1244","52342","32006008","","2009-12-01T00:00:00","528000","484300","1012300","264000","100500","364500"
"1245","52342","32006008","01- Annual","2013-01-01T00:00:00","433200","634600","1067800","240000","177200","417200"
"1246","52342","32006008","","2012-01-01T00:00:00","433200","606800","1040000","240000","174900","414900"
"1247","52342","32006008","","2011-01-01T00:00:00","453200","469500","922700","220000","146800","366800"
"1248","52342","32006008","","2010-01-01T00:00:00","449200","414200","863400","224000","106300","330300"
"1249","53213","32024002","","2010-01-01T00:00:00","72000","201400","273400","20216000","17597000","37813000"
"1250","53213","32024002","","2010-08-01T00:00:00","72000","201400","273400","20216000","14921700","35137700"
"1251","53213","32024002","","2012-08-01T00:00:00","75000","227600","302600","21660000","18025800","39685800"
"1252","53213","32024002","","2011-01-01T00:00:00","69000","220900","289900","19855000","16224800","36079800"
"1253","53213","32024002","","2012-01-01T00:00:00","75000","227600","302600","21660000","18404100","40064100"
"1254","53213","32024002","","2008-11-01T00:00:00","72000","110400","182400","24024000","23831900","47855900"
"1255","53213","32024002","01- Annual","2013-01-01T00:00:00","75000","227600","302600","21660000","22064900","43724900"
"1256","53213","32024002","","2009-01-01T00:00:00","90000","242800","332800","23826000","17555600","41381600"
"1257","53213","32024002","","2008-01-01T00:00:00","72000","110400","182400","24024000","26385500","50409500"
"1259","53213","32024002","05- Review","2014-06-24T00:00:00","75000","235700","310700","21660000","74135400","95795400"
"1260","53213","32024002","01- Annual","2014-01-01T00:00:00","75000","236500","311500","21660000","80955400","102615400"
"1261","53213","32024002","01- Annual","2015-01-01T00:00:00","75000","257600","332600","23826000","77664300","101490300"
"1262","53213","32024002","03- Board of Equalization","2015-08-21T00:00:00","75000","257600","332600","23826000","75172400","98998400"
"1263","53213","32024002","01- Annual","2016-01-01T00:00:00","75000","205900","280900","25270000","78791700","104061700"
"1264","53213","32024002","01- Annual","2018-01-01T00:00:00","75000","201500","276500","21660000","87859800","109519800"
"1265","53213","32024002","03- Board of Equalization","2017-08-31T00:00:00","75000","242100","317100","26714000","18217800","44931800"
"1266","53213","32024002","01- Annual","2017-01-01T00:00:00","75000","242100","317100","26714000","80611100","107325100"
"1267","53213","32024002","03- Board of Equalization","2016-09-07T00:00:00","75000","205900","280900","25270000","25742600","51012600"
"1268","53554","34020024","","2008-01-01T00:00:00","93800","0","93800","17556000","12000000","29556000"
"1269","53554","34020024","","2009-01-01T00:00:00","72000","0","72000","17490000","51245300","68735300"
"1270","53556","34020030","","2009-01-01T00:00:00","4479500","22483400","26962900","29172000","86718100","115890100"
"1271","53556","34020030","","2008-01-01T00:00:00","4479500","25167200","29646700","29172000","95733200","124905200"
"1272","53556","34020030","01- Annual","2013-01-01T00:00:00","4106200","13660200","17766400","26520000","100592400","127112400"
"1273","53556","34020030","","2012-01-01T00:00:00","4106200","13333300","17439500","26520000","100946100","127466100"
"1274","53556","34020030","","2011-01-01T00:00:00","4106200","20248400","24354600","26520000","98851700","125371700"
"1275","53556","34020030","","2010-01-01T00:00:00","3583600","21240200","24823800","24752000","76881400","101633400"
"1276","53556","34020030","01- Annual","2018-01-01T00:00:00","2677500","26456800","29134300","26520000","122550100","149070100"
"1277","53556","34020030","03- Board of Equalization","2017-07-01T00:00:00","2677500","24375950","27053450","32708000","112451850","145159850"
"1278","53556","34020030","01- Annual","2017-01-01T00:00:00","2677500","25283600","27961100","32708000","113359500","146067500"
"1279","53556","34020030","01- Annual","2016-01-01T00:00:00","2677500","22901900","25579400","30940000","116649900","147589900"
"1280","53556","34020030","05- Review","2015-08-12T00:00:00","2677500","21881900","24559400","29172000","116304000","145476000"
"1281","53556","34020030","01- Annual","2015-01-01T00:00:00","2677500","20072500","22750000","29172000","123069600","152241600"
"1282","53556","34020030","01- Annual","2014-01-01T00:00:00","4106200","18643800","22750000","26520000","98780000","125300000"
"1283","53765","34020255","01- Annual","2014-01-01T00:00:00","41600","263800","305400","21810000","129471500","151281500"
"1284","53765","34020255","05- Review","2015-07-28T00:00:00","41600","266400","308000","23991000","133602100","157593100"
"1285","53765","34020255","01- Annual","2015-01-01T00:00:00","41600","271100","312700","23991000","140445200","164436200"
"1286","53765","34020255","01- Annual","2016-01-01T00:00:00","41600","270600","312200","25237300","136061500","161298800"
"1287","53765","34020255","01- Annual","2018-01-01T00:00:00","41600","0","41600","26795100","0","26795100"
"1288","53765","34020255","01- Annual","2017-01-01T00:00:00","41600","565300","606900","26795100","142475500","169270600"
"1289","53765","34020255","","2010-01-01T00:00:00","33300","219800","253100","17480400","95275700","112756100"
"1290","53765","34020255","","2011-01-01T00:00:00","38200","251600","289800","18694300","109085700","127780000"
"1291","53765","34020255","","2012-01-01T00:00:00","41600","273000","314600","21810000","124310400","146120400"
"1292","53765","34020255","01- Annual","2013-01-01T00:00:00","41600","273000","314600","21810000","124310400","146120400"
"1293","53765","34020255","","2008-01-01T00:00:00","41600","247000","288600","20601900","105694200","126296100"
"1294","53765","34020255","","2009-01-01T00:00:00","41600","247600","289200","20601900","103534800","124136700"
"1295","53766","34020256","","2009-01-01T00:00:00","30400","0","30400","15038100","0","15038100"
"1296","53766","34020256","","2008-01-01T00:00:00","30400","0","30400","15038100","0","15038100"
"1297","53766","34020256","01- Annual","2013-01-01T00:00:00","30400","0","30400","15920000","0","15920000"
"1298","53766","34020256","","2012-01-01T00:00:00","30400","0","30400","15920000","0","15920000"
"1299","53766","34020256","","2011-01-01T00:00:00","27800","0","27800","13645700","0","13645700"
"1300","53766","34020256","","2010-01-01T00:00:00","24300","0","24300","12759600","0","12759600"
"1301","53766","34020256","01- Annual","2017-01-01T00:00:00","30400","0","30400","19558900","0","19558900"
"1302","53766","34020256","01- Annual","2018-01-01T00:00:00","30400","0","30400","19558900","0","19558900"
"1303","53766","34020256","01- Annual","2016-01-01T00:00:00","30400","0","30400","18421700","0","18421700"
"1304","53766","34020256","01- Annual","2015-01-01T00:00:00","30400","0","30400","17512000","0","17512000"
"1305","53766","34020256","01- Annual","2014-01-01T00:00:00","30400","0","30400","15920000","0","15920000"
"1306","54061","34027025","01- Annual","2014-01-01T00:00:00","403700","793900","1197600","43190000","111799800","154989800"
"1307","54061","34027025","01- Annual","2015-01-01T00:00:00","403700","823200","1226900","47509000","107429800","154938800"
"1308","54061","34027025","01- Annual","2016-01-01T00:00:00","403700","840000","1243700","49977000","103657700","153634700"
"1309","54061","34027025","01- Annual","2017-01-01T00:00:00","403700","575200","978900","53062000","96607600","149669600"
"1310","54061","34027025","","2010-01-01T00:00:00","323000","2138100","2461100","36512000","97246200","133758200"
"1311","54061","34027025","","2011-10-01T00:00:00","370100","717600","1087700","36772800","104807300","141580100"
"1312","54061","34027025","","2011-01-01T00:00:00","370100","717600","1087700","39120000","105288100","144408100"
"1313","54061","34027025","","2012-01-01T00:00:00","403700","749000","1152700","37020000","121328600","158348600"
"1314","54061","34027025","","2008-09-01T00:00:00","403700","2424600","2828300","43032000","94000000","137032000"
"1315","54061","34027025","01- Annual","2013-01-01T00:00:00","403700","749000","1152700","43190000","101885100","145075100"
"1316","54061","34027025","","2008-01-01T00:00:00","306000","1975600","2281600","43032000","102332300","145364300"
"1317","54061","34027025","","2009-01-01T00:00:00","403700","2436800","2840500","43032000","94244800","137276800"
"1318","54072","35001008","","2009-01-01T00:00:00","272700","469500","742200","25410000","49606700","75016700"
"1319","54072","35001008","","2008-01-01T00:00:00","272700","498000","770700","25410000","54174300","79584300"
"1320","54072","35001008","01- Annual","2013-01-01T00:00:00","272700","667100","939800","26950000","59507000","86457000"
"1321","54072","35001008","","2008-09-01T00:00:00","272700","488100","760800","25410000","50302500","75712500"
"1322","54072","35001008","","2012-01-01T00:00:00","272700","667100","939800","26950000","53440200","80390200"
"1323","54072","35001008","","2011-01-01T00:00:00","250000","561400","811400","23100000","50673100","73773100"
"1324","54072","35001008","","2010-01-01T00:00:00","218200","484000","702200","21560000","44401200","65961200"
"1325","54072","35001008","01- Annual","2017-01-01T00:00:00","272700","1254200","1526900","33110000","65838400","98948400"
"1326","54072","35001008","01- Annual","2016-01-01T00:00:00","272700","1216500","1489200","31185000","64180600","95365600"
"1327","54072","35001008","01- Annual","2015-01-01T00:00:00","272700","1253700","1526400","29645000","64330500","93975500"
"1328","54072","35001008","01- Annual","2014-01-01T00:00:00","272700","1185000","1457700","26950000","63527000","90477000"
"1329","54072","35001008","01- Annual","2018-01-01T00:00:00","272700","1769300","2042000","33110000","73389500","106499500"
"1330","54077","35001019","01- Annual","2018-01-01T00:00:00","365600","733200","1098800","29928000","75615800","105543800"
"1331","54077","35001019","01- Annual","2014-01-01T00:00:00","365600","1847100","2212700","24360000","71333600","95693600"
"1332","54077","35001019","01- Annual","2015-01-01T00:00:00","365600","1913000","2278600","26796000","70021200","96817200"
"1333","54077","35001019","01- Annual","2016-01-01T00:00:00","365600","799400","1165000","28188000","67924800","96112800"
"1334","54077","35001019","05- Review","2015-09-21T00:00:00","286100","864500","1150600","26796000","68026800","94822800"
"1335","54077","35001019","01- Annual","2017-01-01T00:00:00","365600","781400","1147000","29928000","70245000","100173000"
"1336","54077","35001019","","2010-01-01T00:00:00","292500","563700","856200","19488000","39850400","59338400"
"1337","54077","35001019","","2011-01-01T00:00:00","335100","1208800","1543900","20880000","56859700","77739700"
"1338","54077","35001019","","2012-01-01T00:00:00","365600","1289000","1654600","24360000","61652700","86012700"
"1339","54077","35001019","01- Annual","2013-01-01T00:00:00","365600","1289000","1654600","24360000","69350000","93710000"
"1340","54077","35001019","","2008-01-01T00:00:00","365600","714900","1080500","22968000","45927200","68895200"
"1341","54077","35001019","","2009-01-01T00:00:00","365600","701300","1066900","22968000","47136700","70104700"
"1342","54280","35003001","01- Annual","2016-01-01T00:00:00","261800","1000","262800","17696700","0","17696700"
"1343","54280","35003001","01- Annual","2014-01-01T00:00:00","336800","1000","337800","12303900","0","12303900"
"1344","54280","35003001","05- Review","2014-09-08T00:00:00","261800","1000","262800","15293500","0","15293500"
"1345","54280","35003001","01- Annual","2015-01-01T00:00:00","261800","1000","262800","16822600","0","16822600"
"1346","54281","35003002","01- Annual","2015-01-01T00:00:00","216200","1000","217200","13891700","0","13891700"
"1347","54281","35003002","05- Review","2014-09-08T00:00:00","216200","0","216200","12628800","1000","12629800"
"1348","54281","35003002","01- Annual","2014-01-01T00:00:00","278200","1000","279200","10160100","0","10160100"
"1349","54281","35003002","01- Annual","2016-01-01T00:00:00","216200","1000","217200","14613400","0","14613400"
"1350","54282","35003003","05- Review","2016-04-26T00:00:00","242300","7827900","8070200","11549400","133594600","145144000"
"1351","54282","35003003","01- Annual","2016-01-01T00:00:00","242300","7827900","8070200","11549400","138298600","149848000"
"1352","54282","35003003","01- Annual","2015-01-01T00:00:00","242300","2424400","2666700","10979000","134202600","145181600"
"1353","54282","35003003","01- Annual","2014-01-01T00:00:00","242300","2301800","2544100","9980900","129894800","139875700"
"1354","54282","35003003","01- Annual","2018-01-01T00:00:00","242300","7327200","7569500","12262300","132689900","144952200"
"1355","54282","35003003","01- Annual","2017-01-01T00:00:00","242300","8353300","8595600","12262300","130931800","143194100"
"1356","54282","35003003","","2009-01-01T00:00:00","242300","4157400","4399700","9410600","107386200","116796800"
"1357","54282","35003003","","2008-01-01T00:00:00","242300","4377200","4619500","9410600","107720200","117130800"
"1358","54282","35003003","01- Annual","2013-01-01T00:00:00","242300","2082300","2324600","9980900","125646300","135627200"
"1359","54282","35003003","","2012-01-01T00:00:00","242300","2082300","2324600","9980900","125030700","135011600"
"1360","54282","35003003","","2011-01-01T00:00:00","222100","1914000","2136100","8555100","106549900","115105000"
"1361","54282","35003003","","2010-01-01T00:00:00","193800","3429600","3623400","7984700","87497600","95482300"
"1362","54283","35003004","","2010-01-01T00:00:00","174300","0","174300","7179600","0","7179600"
"1363","54283","35003004","","2011-01-01T00:00:00","199700","0","199700","7692500","0","7692500"
"1364","54283","35003004","","2012-01-01T00:00:00","217900","0","217900","8974500","0","8974500"
"1365","54283","35003004","01- Annual","2013-01-01T00:00:00","217900","0","217900","8974500","0","8974500"
"1366","54283","35003004","","2008-01-01T00:00:00","217900","0","217900","8461700","0","8461700"
"1367","54283","35003004","","2009-01-01T00:00:00","217900","0","217900","8461700","0","8461700"
"1368","54283","35003004","01- Annual","2017-01-01T00:00:00","217900","0","217900","11025900","0","11025900"
"1369","54283","35003004","01- Annual","2018-01-01T00:00:00","217900","0","217900","11025900","0","11025900"
"1370","54283","35003004","01- Annual","2014-01-01T00:00:00","217900","0","217900","8974500","0","8974500"
"1371","54283","35003004","01- Annual","2015-01-01T00:00:00","217900","0","217900","9872000","0","9872000"
"1372","54283","35003004","01- Annual","2016-01-01T00:00:00","217900","0","217900","10384800","0","10384800"
"1373","54284","35003005","01- Annual","2016-01-01T00:00:00","217900","0","217900","10384800","0","10384800"
"1374","54284","35003005","01- Annual","2015-01-01T00:00:00","217900","0","217900","9872000","0","9872000"
"1375","54284","35003005","01- Annual","2014-01-01T00:00:00","217900","0","217900","8974500","0","8974500"
"1376","54284","35003005","01- Annual","2018-01-01T00:00:00","217900","0","217900","11025900","0","11025900"
"1377","54284","35003005","01- Annual","2017-01-01T00:00:00","217900","0","217900","11025900","0","11025900"
"1378","54284","35003005","","2009-01-01T00:00:00","217900","0","217900","8461700","0","8461700"
"1379","54284","35003005","","2008-01-01T00:00:00","217900","0","217900","8461700","0","8461700"
"1380","54284","35003005","01- Annual","2013-01-01T00:00:00","217900","0","217900","8974500","0","8974500"
"1381","54284","35003005","","2012-01-01T00:00:00","217900","0","217900","8974500","0","8974500"
"1382","54284","35003005","","2011-01-01T00:00:00","199700","0","199700","7692500","0","7692500"
"1383","54284","35003005","","2010-01-01T00:00:00","174300","0","174300","7179600","0","7179600"
"1384","54285","35003006","","2010-01-01T00:00:00","129900","1924200","2054100","5600000","73003600","78603600"
"1385","54285","35003006","","2010-10-01T00:00:00","129900","1924200","2054100","5600000","55346600","60946600"
"1386","54285","35003006","","2011-01-01T00:00:00","148800","2070400","2219200","6000000","82072500","88072500"
"1387","54285","35003006","","2012-01-01T00:00:00","162400","2217400","2379800","7000000","87353800","94353800"
"1388","54285","35003006","01- Annual","2013-01-01T00:00:00","162400","2246800","2409200","7000000","91790100","98790100"
"1389","54285","35003006","","2008-01-01T00:00:00","162400","0","162400","6600000","0","6600000"
"1390","54285","35003006","","2009-01-01T00:00:00","162400","0","162400","6600000","12816800","19416800"
"1391","54285","35003006","01- Annual","2017-01-01T00:00:00","162400","1972300","2134700","8600000","91249100","99849100"
"1392","54285","35003006","05- Review","2016-09-22T00:00:00","162400","1977700","2140100","8100000","94753200","102853200"
"1393","54285","35003006","01- Annual","2018-01-01T00:00:00","162400","0","162400","8600000","0","8600000"
"1394","54285","35003006","03- Board of Equalization","2017-10-31T00:00:00","162400","1899600","2062000","8762400","89608700","98371100"
"1395","54285","35003006","05- Review","2018-03-29T00:00:00","162400","1944700","2107100","8600000","96736600","105336600"
"1396","54285","35003006","01- Annual","2014-01-01T00:00:00","162400","2325500","2487900","7000000","94669200","101669200"
"1397","54285","35003006","01- Annual","2015-01-01T00:00:00","162400","2386700","2549100","7700000","101104700","108804700"
"1398","54285","35003006","01- Annual","2016-01-01T00:00:00","162400","2351300","2513700","8100000","98582200","106682200"
"1399","54286","35003007","01- Annual","2016-01-01T00:00:00","162400","0","162400","8100000","0","8100000"
"1400","54286","35003007","01- Annual","2015-01-01T00:00:00","162400","0","162400","7700000","0","7700000"
"1401","54286","35003007","01- Annual","2014-01-01T00:00:00","162400","0","162400","7000000","0","7000000"
"1402","54286","35003007","01- Annual","2018-01-01T00:00:00","162400","0","162400","8600000","0","8600000"
"1403","54286","35003007","01- Annual","2017-01-01T00:00:00","162400","0","162400","8600000","0","8600000"
"1404","54286","35003007","","2009-01-01T00:00:00","162400","0","162400","6600000","0","6600000"
"1405","54286","35003007","","2008-01-01T00:00:00","162400","0","162400","6600000","0","6600000"
"1406","54286","35003007","01- Annual","2013-01-01T00:00:00","162400","0","162400","7000000","0","7000000"
"1407","54286","35003007","","2012-01-01T00:00:00","162400","0","162400","7000000","0","7000000"
"1408","54286","35003007","","2011-01-01T00:00:00","148800","0","148800","6000000","0","6000000"
"1409","54286","35003007","","2010-01-01T00:00:00","129900","0","129900","5600000","0","5600000"
"1410","54287","35003008","","2010-01-01T00:00:00","129900","0","129900","5600000","0","5600000"
"1411","54287","35003008","","2011-01-01T00:00:00","148800","0","148800","6000000","0","6000000"
"1412","54287","35003008","","2012-01-01T00:00:00","162400","0","162400","7000000","0","7000000"
"1413","54287","35003008","01- Annual","2013-01-01T00:00:00","162400","0","162400","7000000","0","7000000"
"1414","54287","35003008","","2008-01-01T00:00:00","162400","0","162400","6600000","0","6600000"
"1415","54287","35003008","","2009-01-01T00:00:00","162400","0","162400","6600000","0","6600000"
"1416","54287","35003008","01- Annual","2017-01-01T00:00:00","162400","0","162400","8600000","0","8600000"
"1417","54287","35003008","01- Annual","2018-01-01T00:00:00","162400","0","162400","8600000","0","8600000"
"1418","54287","35003008","01- Annual","2014-01-01T00:00:00","162400","0","162400","7000000","0","7000000"
"1419","54287","35003008","01- Annual","2015-01-01T00:00:00","162400","0","162400","7700000","0","7700000"
"1420","54287","35003008","01- Annual","2016-01-01T00:00:00","162400","0","162400","8100000","0","8100000"
"1421","54289","35003010","","2011-01-01T00:00:00","899300","0","899300","23185700","0","23185700"
"1422","54289","35003010","","2012-01-01T00:00:00","981000","0","981000","27295700","0","27295700"
"1423","54290","35003011","01- Annual","2014-01-01T00:00:00","849800","1000","850800","31041600","0","31041600"
"1424","54290","35003011","05- Review","2014-09-08T00:00:00","2327400","1000","2328400","44078300","0","44078300"
"1425","54293","35003015","05- Review","2014-09-08T00:00:00","232000","1000","233000","13550900","0","13550900"
"1426","54293","35003015","01- Annual","2015-01-01T00:00:00","232000","1000","233000","14906000","0","14906000"
"1427","54293","35003015","01- Annual","2014-01-01T00:00:00","298500","1000","299500","10901900","0","10901900"
"1428","54293","35003015","01- Annual","2016-01-01T00:00:00","232000","1000","233000","15680300","0","15680300"
"1429","54293","35003015","01- Annual","2017-01-01T00:00:00","196800","0","196800","16840400","1000","16841400"
"1430","54293","35003015","01- Annual","2018-01-01T00:00:00","196800","0","196800","16840400","0","16840400"
"1431","54294","35003016","01- Annual","2018-01-01T00:00:00","102800","0","102800","8793500","0","8793500"
"1432","54294","35003016","01- Annual","2017-01-01T00:00:00","102800","0","102800","8793500","1000","8794500"
"1433","54294","35003016","01- Annual","2016-01-01T00:00:00","121100","1000","122100","8187700","0","8187700"
"1434","54294","35003016","01- Annual","2014-01-01T00:00:00","155800","1000","156800","5692600","0","5692600"
"1435","54294","35003016","01- Annual","2015-01-01T00:00:00","121100","1000","122100","7783300","0","7783300"
"1436","54294","35003016","05- Review","2014-09-08T00:00:00","121100","1000","122100","7075800","0","7075800"
"1437","54295","35003017","05- Review","2014-09-08T00:00:00","121100","1000","122100","7075800","0","7075800"
"1438","54295","35003017","01- Annual","2015-01-01T00:00:00","121100","1000","122100","7783300","0","7783300"
"1439","54295","35003017","01- Annual","2014-01-01T00:00:00","155800","1000","156800","5692600","0","5692600"
"1440","54295","35003017","01- Annual","2016-01-01T00:00:00","121100","1000","122100","8187700","0","8187700"
"1441","54295","35003017","01- Annual","2017-01-01T00:00:00","102800","0","102800","8793500","1000","8794500"
"1442","54295","35003017","01- Annual","2018-01-01T00:00:00","102800","0","102800","8793500","0","8793500"
"1443","54296","35003018","01- Annual","2018-01-01T00:00:00","102800","0","102800","8796700","0","8796700"
"1444","54296","35003018","01- Annual","2017-01-01T00:00:00","102800","0","102800","8796700","1000","8797700"
"1445","54296","35003018","01- Annual","2016-01-01T00:00:00","121200","1000","122200","8190700","0","8190700"
"1446","54296","35003018","01- Annual","2014-01-01T00:00:00","155900","1000","156900","5694700","0","5694700"
"1447","54296","35003018","01- Annual","2015-01-01T00:00:00","121200","1000","122200","7786200","0","7786200"
"1448","54296","35003018","05- Review","2014-09-08T00:00:00","121200","1000","122200","7078400","0","7078400"
"1449","54297","35003019","05- Review","2014-09-08T00:00:00","121400","1000","122400","7092700","0","7092700"
"1450","54297","35003019","01- Annual","2015-01-01T00:00:00","121400","1000","122400","7802000","0","7802000"
"1451","54297","35003019","01- Annual","2014-01-01T00:00:00","156200","1000","157200","5706300","0","5706300"
"1452","54297","35003019","01- Annual","2016-01-01T00:00:00","121400","1000","122400","8207300","0","8207300"
"1453","54298","35003020","01- Annual","2016-01-01T00:00:00","121300","1000","122300","8197500","0","8197500"
"1454","54298","35003020","01- Annual","2014-01-01T00:00:00","156000","1000","157000","5699400","0","5699400"
"1455","54298","35003020","01- Annual","2015-01-01T00:00:00","121300","1000","122300","7792700","0","7792700"
"1456","54298","35003020","05- Review","2014-09-08T00:00:00","121300","0","121300","7084300","1000","7085300"
"1457","54299","35003021","05- Review","2014-09-08T00:00:00","113100","1000","114100","6608900","0","6608900"
"1458","54299","35003021","01- Annual","2015-01-01T00:00:00","113100","1000","114100","7269800","0","7269800"
"1459","54299","35003021","01- Annual","2014-01-01T00:00:00","145500","1000","146500","5317000","0","5317000"
"1460","54299","35003021","01- Annual","2016-01-01T00:00:00","113100","1000","114100","7647400","0","7647400"
"1461","54325","35005022","01- Annual","2017-01-01T00:00:00","37700","75600","113300","25714000","74038100","99752100"
"1462","54325","35005022","03- Board of Equalization","2015-08-21T00:00:00","37700","70000","107700","23023000","75417900","98440900"
"1463","54325","35005022","01- Annual","2016-01-01T00:00:00","37700","74400","112100","24219000","75448200","99667200"
"1464","54325","35005022","01- Annual","2015-01-01T00:00:00","37700","70000","107700","23023000","76519600","99542600"
"1465","54325","35005022","01- Annual","2014-01-01T00:00:00","37700","65200","102900","20930000","69740500","90670500"
"1466","54325","35005022","01- Annual","2018-01-01T00:00:00","37700","70800","108500","25714000","76810400","102524400"
"1467","54325","35005022","","2012-01-01T00:00:00","37700","64900","102600","20930000","62779900","83709900"
"1468","54325","35005022","","2011-01-01T00:00:00","35200","92400","127600","17940000","55043100","72983100"
"1469","54325","35005022","","2010-01-01T00:00:00","30100","40500","70600","16744000","46730500","63474500"
"1470","54325","35005022","","2009-01-01T00:00:00","37700","48200","85900","19734000","57488200","77222200"
"1471","54325","35005022","","2008-01-01T00:00:00","37700","48200","85900","19734000","52556600","72290600"
"1472","54325","35005022","01- Annual","2013-01-01T00:00:00","37700","61600","99300","20930000","58416600","79346600"
"1473","54334","35005031","01- Annual","2013-01-01T00:00:00","21162600","102560400","123723000","35280000","139529400","174809400"
"1474","54334","35005031","","2008-01-01T00:00:00","21162600","102921200","124083800","33264000","88414500","121678500"
"1475","54334","35005031","","2009-01-01T00:00:00","21162600","108647600","129810200","33264000","92762700","126026700"
"1476","54334","35005031","","2010-01-01T00:00:00","16930100","94052700","110982800","33264000","78624500","111888500"
"1477","54334","35005031","","2011-01-01T00:00:00","19399100","106863300","126262400","30240000","79110600","109350600"
"1478","54334","35005031","","2012-01-01T00:00:00","21162600","99676600","120839200","35280000","75891500","111171500"
"1479","54334","35005031","01- Annual","2018-01-01T00:00:00","21162600","167319800","188482400","43344000","138845100","182189100"
"1480","54334","35005031","03- Board of Equalization","2017-10-10T00:00:00","21162600","118054300","139216900","43344000","130236400","173580400"
"1481","54334","35005031","01- Annual","2014-01-01T00:00:00","21162600","104174700","125337300","35280000","144093700","179373700"
"1482","54334","35005031","01- Annual","2015-01-01T00:00:00","21162600","108636600","129799200","38808000","141029100","179837100"
"1483","54334","35005031","01- Annual","2016-01-01T00:00:00","21162600","115744400","136907000","40824000","138609300","179433300"
"1484","54334","35005031","03- Board of Equalization","2015-11-03T00:00:00","21162600","106662970","127825570","38808000","138294630","177102630"
"1485","54334","35005031","01- Annual","2017-01-01T00:00:00","21162600","126655400","147818000","43344000","130236400","173580400"
"1486","54334","35005031","05- Review","2016-06-30T00:00:00","21162600","115744400","136907000","40824000","130890000","171714000"
"1487","55126","35008005","01- Annual","2017-01-01T00:00:00","158100","691000","849100","25972000","21785500","47757500"
"1488","55126","35008005","01- Annual","2016-01-01T00:00:00","158100","649000","807100","24462000","21284400","45746400"
"1489","55126","35008005","05- Review","2015-07-28T00:00:00","158100","688600","846700","23254000","24742200","47996200"
"1490","55126","35008005","01- Annual","2015-01-01T00:00:00","158100","637300","795400","23254000","27087700","50341700"
"1491","55126","35008005","01- Annual","2014-01-01T00:00:00","158100","565800","723900","21140000","24381300","45521300"
"1492","55126","35008005","01- Annual","2018-01-01T00:00:00","158100","861800","1019900","18120000","30850100","48970100"
"1493","55126","35008005","","2012-01-01T00:00:00","158100","545300","703400","21140000","22593700","43733700"
"1494","55126","35008005","","2011-01-01T00:00:00","144900","278400","423300","18120000","18493800","36613800"
"1495","55126","35008005","","2010-01-01T00:00:00","126500","37100","163600","16912000","11426100","28338100"
"1496","55126","35008005","","2009-01-01T00:00:00","158100","98700","256800","19932000","14971800","34903800"
"1497","55126","35008005","","2008-01-01T00:00:00","158100","86000","244100","19932000","21477600","41409600"
"1498","55126","35008005","01- Annual","2013-01-01T00:00:00","158100","545800","703900","21140000","22725600","43865600"
"1499","55126","35008005","","2008-11-01T00:00:00","158100","86000","244100","19932000","21470800","41402800"
"1500","55375","35010023","01- Annual","2013-01-01T00:00:00","185500","673600","859100","36512100","45408700","81920800"
"1501","55375","35010023","","2010-01-01T00:00:00","148400","624800","773200","29209700","34315700","63525400"
"1502","55375","35010023","","2011-01-01T00:00:00","170000","627100","797100","31296100","34315700","65611800"
"1503","55375","35010023","","2012-01-01T00:00:00","185500","660000","845500","36512100","45636200","82148300"
"1504","55375","35010023","01- Annual","2018-01-01T00:00:00","185500","0","185500","44857700","0","44857700"
"1505","55375","35010023","01- Annual","2017-01-01T00:00:00","185500","2136300","2321800","44857700","69088800","113946500"
"1506","55375","35010023","01- Annual","2014-01-01T00:00:00","185500","764200","949700","36512100","45810000","82322100"
"1507","55375","35010023","01- Annual","2015-01-01T00:00:00","185500","961800","1147300","40163300","67719200","107882500"
"1508","55375","35010023","01- Annual","2016-01-01T00:00:00","185500","1566800","1752300","42249700","70183400","112433100"
"1509","55380","35010032","01- Annual","2016-01-01T00:00:00","208900","0","208900","47582800","101376100","148958900"
"1510","55380","35010032","01- Annual","2015-01-01T00:00:00","208900","0","208900","45233000","97816600","143049600"
"1511","55380","35010032","01- Annual","2014-01-01T00:00:00","208900","0","208900","41120900","66170100","107291000"
"1512","55380","35010032","01- Annual","2017-01-01T00:00:00","208900","0","208900","50520000","99794900","150314900"
"1513","55380","35010032","01- Annual","2018-01-01T00:00:00","208900","0","208900","50520000","0","50520000"
"1514","55380","35010032","","2012-01-01T00:00:00","208900","0","208900","41120900","65324400","106445300"
"1515","55380","35010032","","2011-01-01T00:00:00","191500","0","191500","35246500","49120000","84366500"
"1516","55380","35010032","","2010-01-01T00:00:00","167100","0","167100","32896700","49120000","82016700"
"1517","55380","35010032","01- Annual","2013-01-01T00:00:00","208900","0","208900","41120900","64845600","105966500"
"1518","55381","35010033","01- Annual","2013-01-01T00:00:00","199500","0","199500","39267000","57305500","96572500"
"1519","55381","35010033","","2010-01-01T00:00:00","159600","0","159600","31413600","43350100","74763700"
"1520","55381","35010033","","2011-01-01T00:00:00","182800","0","182800","33657400","43350100","77007500"
"1521","55381","35010033","","2012-01-01T00:00:00","199500","0","199500","39267000","57651100","96918100"
"1522","55381","35010033","01- Annual","2018-01-01T00:00:00","199500","0","199500","48242300","0","48242300"
"1523","55381","35010033","01- Annual","2017-01-01T00:00:00","199500","0","199500","48242300","87000700","135243000"
"1524","55381","35010033","01- Annual","2014-01-01T00:00:00","199500","0","199500","39267000","57686700","96953700"
"1525","55381","35010033","01- Annual","2015-01-01T00:00:00","199500","0","199500","43193700","85276000","128469700"
"1526","55381","35010033","01- Annual","2016-01-01T00:00:00","199500","0","199500","45437500","88379100","133816600"
"1527","55383","35011007","","2012-01-01T00:00:00","205200","555100","760300","39779900","96643000","136422900"
"1528","55383","35011007","","2011-01-01T00:00:00","188100","599300","787400","34097100","79465900","113563000"
"1529","55383","35011007","","2010-01-01T00:00:00","164200","491800","656000","31823900","70551500","102375400"
"1530","55383","35011007","01- Annual","2013-01-01T00:00:00","0","0","0","0","0","0"
"1531","55383","35011007","01- Annual","2013-01-01T00:00:00","205200","582500","787700","39779900","105198200","144978100"
"1532","55383","35011007","","2008-01-01T00:00:00","205200","750800","956000","37506800","85696900","123203700"
"1533","55383","35011007","","2009-01-01T00:00:00","205200","704600","909800","37506800","81070300","118577100"
"1534","55384","35011008","","2009-01-01T00:00:00","200600","0","200600","36677200","134226200","170903400"
"1535","55384","35011008","","2008-01-01T00:00:00","200600","0","200600","36677200","141913000","178590200"
"1536","55384","35011008","01- Annual","2013-01-01T00:00:00","200700","0","200700","38900100","157797300","196697400"
"1537","55384","35011008","","2010-01-01T00:00:00","160500","0","160500","31120100","112994900","144115000"
"1538","55384","35011008","","2011-01-01T00:00:00","183900","0","183900","33342900","120549900","153892800"
"1539","55384","35011008","","2012-01-01T00:00:00","200600","0","200600","38900100","151265900","190166000"
"1540","55663","36018005","","2012-01-01T00:00:00","206400","721500","927900","120000","284800","404800"
"1541","55663","36018005","","2011-01-01T00:00:00","216400","655300","871700","110000","252000","362000"
"1542","55663","36018005","","2010-01-01T00:00:00","214400","631700","846100","112000","193900","305900"
"1543","55663","36018005","01- Annual","2013-01-01T00:00:00","206400","722000","928400","120000","288300","408300"
"1544","55663","36018005","","2008-01-01T00:00:00","155500","2148500","2304000","132000","217500","349500"
"1545","55663","36018005","","2009-01-01T00:00:00","380000","564700","944700","132000","230500","362500"
"1546","55663","36018005","01- Annual","2015-01-01T00:00:00","326400","1728000","2054400","0","615400","615400"
"1547","55663","36018005","01- Annual","2014-01-01T00:00:00","206400","1464200","1670600","120000","383400","503400"
"1548","55672","36018014","01- Annual","2014-01-01T00:00:00","496800","2827500","3324300","75250000","130886900","206136900"
"1549","55672","36018014","01- Annual","2015-01-01T00:00:00","496800","2827500","3324300","63756000","148387000","212143000"
"1550","55672","36018014","01- Annual","2016-01-01T00:00:00","496800","2728400","3225200","87075000","148090700","235165700"
"1551","55672","36018014","01- Annual","2017-01-01T00:00:00","496800","1984700","2481500","92450000","141657800","234107800"
"1552","55672","36018014","03- Board of Equalization","2016-09-07T00:00:00","496800","2728400","3225200","87075000","134421500","221496500"
"1553","55672","36018014","01- Annual","2018-01-01T00:00:00","496800","2174000","2670800","92450000","208206200","300656200"
"1554","55672","36018014","03- Board of Equalization","2017-10-17T00:00:00","496800","1989800","2486600","92450000","132265300","224715300"
"1555","55672","36018014","","2009-01-01T00:00:00","496800","862400","1359200","70950000","124596200","195546200"
"1556","55672","36018014","","2008-01-01T00:00:00","496800","879800","1376600","70950000","113711600","184661600"
"1557","55672","36018014","01- Annual","2013-01-01T00:00:00","496800","2847200","3344000","75250000","130854000","206104000"
"1558","55672","36018014","","2010-01-01T00:00:00","397400","799100","1196500","60200000","111494300","171694300"
"1559","55672","36018014","","2011-01-01T00:00:00","455400","2576600","3032000","64500000","115453300","179953300"
"1560","55672","36018014","","2012-01-01T00:00:00","496800","2847200","3344000","75250000","130718800","205968800"
"1561","56542","37010004","","2012-01-01T00:00:00","195800","15000","210800","452300","147400","599700"
"1562","56542","37010004","","2011-01-01T00:00:00","195800","15000","210800","452300","147400","599700"
"1563","56542","37010004","","2010-01-01T00:00:00","195800","15000","210800","452300","147400","599700"
"1564","56542","37010004","01- Annual","2013-01-01T00:00:00","195800","15000","210800","452300","147400","599700"
"1565","56542","37010004","","2008-01-01T00:00:00","217500","15000","232500","502500","147400","649900"
"1566","56542","37010004","","2009-01-01T00:00:00","217500","15000","232500","502500","147400","649900"
"1567","56542","37010004","01- Annual","2016-01-01T00:00:00","226100","4300","230400","522400","147400","669800"
"1568","56542","37010004","01- Annual","2015-01-01T00:00:00","215400","15000","230400","497500","147400","644900"
"1569","56542","37010004","01- Annual","2014-01-01T00:00:00","195800","15000","210800","452300","147400","599700"
"1570","58083","38011004","01- Annual","2014-01-01T00:00:00","53400","1802700","1856100","7985100","199725000","207710100"
"1571","58083","38011004","01- Annual","2015-01-01T00:00:00","53400","1838200","1891600","8783600","198003000","206786600"
"1572","58083","38011004","03- Board of Equalization","2015-10-07T00:00:00","53400","1784713","1838113","8783600","192155987","200939587"
"1573","58083","38011004","01- Annual","2016-01-01T00:00:00","53400","1908800","1962200","9182800","193340700","202523500"
"1574","58083","38011004","01- Annual","2018-01-01T00:00:00","53400","1819900","1873300","9642000","194044400","203686400"
"1575","58083","38011004","01- Annual","2017-01-01T00:00:00","53400","1908800","1962200","9642000","189435200","199077200"
"1576","58083","38011004","","2009-01-01T00:00:00","41000","579500","620500","7210500","148148800","155359300"
"1577","58083","38011004","","2008-01-01T00:00:00","41000","524900","565900","7210500","151949600","159160100"
"1578","58083","38011004","01- Annual","2013-01-01T00:00:00","53400","1454300","1507700","7985100","180426500","188411600"
"1579","58083","38011004","","2010-01-01T00:00:00","51300","1141900","1193200","6128600","138156100","144284700"
"1580","58083","38011004","","2011-01-01T00:00:00","49100","1312500","1361600","6128600","160193900","166322500"
"1581","58083","38011004","","2012-01-01T00:00:00","53400","1435300","1488700","7985100","170898400","178883500"
"1582","58084","38011005","","2012-01-01T00:00:00","27100","0","27100","4049900","0","4049900"
"1583","58084","38011005","","2011-01-01T00:00:00","24900","0","24900","3108300","0","3108300"
"1584","58084","38011005","","2010-01-01T00:00:00","26000","0","26000","3108300","0","3108300"
"1585","58084","38011005","01- Annual","2013-01-01T00:00:00","27100","0","27100","4049900","0","4049900"
"1586","58084","38011005","","2008-01-01T00:00:00","20800","0","20800","3657100","0","3657100"
"1587","58084","38011005","","2009-01-01T00:00:00","20800","0","20800","3657100","0","3657100"
"1588","58084","38011005","01- Annual","2017-01-01T00:00:00","27100","0","27100","4890300","0","4890300"
"1589","58084","38011005","01- Annual","2018-01-01T00:00:00","27100","0","27100","4890300","0","4890300"
"1590","58084","38011005","01- Annual","2016-01-01T00:00:00","27100","0","27100","4657400","0","4657400"
"1591","58084","38011005","01- Annual","2015-01-01T00:00:00","27100","0","27100","4454900","0","4454900"
"1592","58084","38011005","01- Annual","2014-01-01T00:00:00","27100","0","27100","4049900","0","4049900"
"1593","58086","38011007","01- Annual","2014-01-01T00:00:00","79100","0","79100","11830400","0","11830400"
"1594","58086","38011007","01- Annual","2015-01-01T00:00:00","79100","0","79100","13013500","0","13013500"
"1595","58086","38011007","01- Annual","2016-01-01T00:00:00","79100","0","79100","13605000","0","13605000"
"1596","58086","38011007","01- Annual","2018-01-01T00:00:00","79100","0","79100","14285200","0","14285200"
"1597","58086","38011007","01- Annual","2017-01-01T00:00:00","79100","0","79100","14285200","0","14285200"
"1598","58086","38011007","","2009-01-01T00:00:00","60700","0","60700","10682900","0","10682900"
"1599","58086","38011007","","2008-01-01T00:00:00","60700","0","60700","10682900","0","10682900"
"1600","58086","38011007","01- Annual","2013-01-01T00:00:00","79100","0","79100","11830400","0","11830400"
"1601","58086","38011007","","2010-01-01T00:00:00","76000","0","76000","9079900","0","9079900"
"1602","58086","38011007","","2011-01-01T00:00:00","72800","0","72800","9079900","0","9079900"
"1603","58086","38011007","","2012-01-01T00:00:00","79100","0","79100","11830400","0","11830400"
"1604","58087","38011008","","2012-01-01T00:00:00","51600","0","51600","7719500","0","7719500"
"1605","58087","38011008","","2011-01-01T00:00:00","47500","0","47500","5924700","0","5924700"
"1606","58087","38011008","","2010-01-01T00:00:00","49600","0","49600","5924700","0","5924700"
"1607","58087","38011008","01- Annual","2013-01-01T00:00:00","51600","0","51600","7719500","0","7719500"
"1608","58087","38011008","","2008-01-01T00:00:00","39600","0","39600","6970700","0","6970700"
"1609","58087","38011008","","2009-01-01T00:00:00","39600","0","39600","6970700","0","6970700"
"1610","58087","38011008","01- Annual","2017-01-01T00:00:00","51600","0","51600","9321300","0","9321300"
"1611","58087","38011008","01- Annual","2018-01-01T00:00:00","51600","0","51600","9321300","0","9321300"
"1612","58087","38011008","01- Annual","2016-01-01T00:00:00","51600","0","51600","8877400","0","8877400"
"1613","58087","38011008","01- Annual","2015-01-01T00:00:00","51600","0","51600","8491400","0","8491400"
"1614","58087","38011008","01- Annual","2014-01-01T00:00:00","51600","0","51600","7719500","0","7719500"
"1615","58088","38011009","01- Annual","2014-01-01T00:00:00","11100","0","11100","1653300","0","1653300"
"1616","58088","38011009","01- Annual","2015-01-01T00:00:00","11100","0","11100","1818600","0","1818600"
"1617","58088","38011009","01- Annual","2016-01-01T00:00:00","11100","0","11100","1901300","0","1901300"
"1618","58088","38011009","01- Annual","2018-01-01T00:00:00","11100","0","11100","1996400","0","1996400"
"1619","58088","38011009","01- Annual","2017-01-01T00:00:00","11100","0","11100","1996400","0","1996400"
"1620","58088","38011009","","2009-01-01T00:00:00","8500","0","8500","1492900","0","1492900"
"1621","58088","38011009","","2008-01-01T00:00:00","8500","0","8500","1492900","0","1492900"
"1622","58088","38011009","01- Annual","2013-01-01T00:00:00","11100","0","11100","1653300","0","1653300"
"1623","58088","38011009","","2010-01-01T00:00:00","10600","0","10600","1268900","0","1268900"
"1624","58088","38011009","","2011-01-01T00:00:00","10200","0","10200","1268900","0","1268900"
"1625","58088","38011009","","2012-01-01T00:00:00","11100","0","11100","1653300","0","1653300"
"1626","58089","38011010","","2012-01-01T00:00:00","8700","0","8700","1294700","0","1294700"
"1627","58089","38011010","","2011-01-01T00:00:00","8000","0","8000","993700","0","993700"
"1628","58089","38011010","","2010-01-01T00:00:00","8300","0","8300","993700","0","993700"
"1629","58089","38011010","01- Annual","2013-01-01T00:00:00","8700","0","8700","1294700","0","1294700"
"1630","58089","38011010","","2008-01-01T00:00:00","6600","0","6600","1169200","0","1169200"
"1631","58089","38011010","","2009-01-01T00:00:00","6600","0","6600","1169200","0","1169200"
"1632","58089","38011010","01- Annual","2017-01-01T00:00:00","8700","0","8700","1563400","0","1563400"
"1633","58089","38011010","01- Annual","2018-01-01T00:00:00","8700","0","8700","1563400","0","1563400"
"1634","58089","38011010","01- Annual","2016-01-01T00:00:00","8700","0","8700","1488900","0","1488900"
"1635","58089","38011010","01- Annual","2015-01-01T00:00:00","8700","0","8700","1424200","0","1424200"
"1636","58089","38011010","01- Annual","2014-01-01T00:00:00","8700","0","8700","1294700","0","1294700"
"1637","58091","38011012","01- Annual","2014-01-01T00:00:00","106900","0","106900","15984600","0","15984600"
"1638","58091","38011012","01- Annual","2015-01-01T00:00:00","106900","0","106900","17583100","0","17583100"
"1639","58091","38011012","01- Annual","2016-01-01T00:00:00","106900","0","106900","18382300","0","18382300"
"1640","58091","38011012","01- Annual","2018-01-01T00:00:00","106900","0","106900","19301400","0","19301400"
"1641","58091","38011012","01- Annual","2017-01-01T00:00:00","106900","0","106900","19301400","0","19301400"
"1642","58091","38011012","","2009-01-01T00:00:00","82100","0","82100","14434100","0","14434100"
"1643","58091","38011012","","2008-01-01T00:00:00","82100","0","82100","14434100","0","14434100"
"1644","58091","38011012","01- Annual","2013-01-01T00:00:00","106900","0","106900","15984600","0","15984600"
"1645","58091","38011012","","2010-01-01T00:00:00","102600","0","102600","12268200","0","12268200"
"1646","58091","38011012","","2011-01-01T00:00:00","98400","0","98400","12268200","0","12268200"
"1647","58091","38011012","","2012-01-01T00:00:00","106900","0","106900","15984700","0","15984700"
"1648","58092","38011011","","2012-01-01T00:00:00","12000","0","12000","1794400","0","1794400"
"1649","58092","38011011","","2011-01-01T00:00:00","11000","0","11000","1377200","0","1377200"
"1650","58092","38011011","","2010-01-01T00:00:00","11500","0","11500","1377200","0","1377200"
"1651","58092","38011011","","2009-01-01T00:00:00","9200","0","9200","1620400","0","1620400"
"1652","58092","38011011","","2008-01-01T00:00:00","9200","0","9200","1620400","0","1620400"
"1653","58092","38011011","01- Annual","2013-01-01T00:00:00","12000","0","12000","1794400","0","1794400"
"1654","58092","38011011","01- Annual","2017-01-01T00:00:00","12000","0","12000","2166800","0","2166800"
"1655","58092","38011011","01- Annual","2018-01-01T00:00:00","12000","0","12000","2166800","0","2166800"
"1656","58092","38011011","01- Annual","2016-01-01T00:00:00","12000","0","12000","2063600","0","2063600"
"1657","58092","38011011","01- Annual","2015-01-01T00:00:00","12000","0","12000","1973900","0","1973900"
"1658","58092","38011011","01- Annual","2014-01-01T00:00:00","12000","0","12000","1794400","0","1794400"
"1659","58116","18016019","01- Annual","2014-01-01T00:00:00","12754300","69309500","82063800","21000000","101271300","122271300"
"1660","58116","18016019","01- Annual","2015-01-01T00:00:00","12754300","77491300","90245600","23100000","109425400","132525400"
"1661","58116","18016019","01- Annual","2016-01-01T00:00:00","12754300","82345100","95099400","24300000","111482600","135782600"
"1662","58116","18016019","","2008-01-01T00:00:00","12754300","82094500","94848800","19800000","39934300","59734300"
"1663","58116","18016019","01- Annual","2013-01-01T00:00:00","12754300","67517600","80271900","21000000","84741400","105741400"
"1664","58116","18016019","","2009-01-01T00:00:00","12754300","68448400","81202700","19800000","44019400","63819400"
"1665","58116","18016019","","2010-01-01T00:00:00","10203500","62135800","72339300","16800000","40866500","57666500"
"1666","58116","18016019","","2011-01-01T00:00:00","11691500","66977000","78668500","18000000","45147700","63147700"
"1667","58116","18016019","","2012-01-01T00:00:00","12754300","67121400","79875700","21000000","44195500","65195500"
"1668","58264","15058015","","2012-01-01T00:00:00","189400","1256800","1446200","15330000","62935200","78265200"
"1669","58264","15058015","","2011-01-01T00:00:00","173600","1260900","1434500","13140000","56113000","69253000"
"1670","58264","15058015","","2010-01-01T00:00:00","151500","1167300","1318800","12264000","51354300","63618300"
"1671","58264","15058015","","2008-01-01T00:00:00","189400","1160200","1349600","14454000","58596800","73050800"
"1672","58264","15058015","","2009-01-01T00:00:00","189400","1049900","1239300","14454000","53544600","67998600"
"1673","58410","19015052","","2008-01-01T00:00:00","221100","238000","459100","66000","23800","89800"
"1674","58410","19015052","01- Annual","2013-01-01T00:00:00","33000","337700","370700","180000","67400","247400"
"1675","58410","19015052","","2009-01-01T00:00:00","15000","345500","360500","198000","97300","295300"
"1676","58410","19015052","","2010-01-01T00:00:00","45000","262500","307500","168000","99600","267600"
"1677","58410","19015052","","2011-01-01T00:00:00","48000","269600","317600","165000","149400","314400"
"1678","58410","19015052","","2012-01-01T00:00:00","33000","305100","338100","180000","169100","349100"
"1679","58410","19015052","01- Annual","2014-01-01T00:00:00","125600","280700","406300","125600","93800","219400"
"1680","58410","19015052","01- Annual","2015-01-01T00:00:00","251200","155100","406300","0","225500","225500"
"1681","58884","14038008","01- Annual","2015-01-01T00:00:00","429000","3928100","4357100","17787000","73845500","91632500"
"1682","58884","14038008","01- Annual","2014-01-01T00:00:00","429000","2984400","3413400","16170000","68485100","84655100"
"1683","58884","14038008","01- Annual","2016-01-01T00:00:00","429000","3932400","4361400","18711000","77198000","95909000"
"1684","58884","14038008","01- Annual","2017-01-01T00:00:00","429000","4246500","4675500","19866000","78733900","98599900"
"1685","58884","14038008","01- Annual","2018-01-01T00:00:00","429000","3729500","4158500","19866000","79326600","99192600"
"1686","58884","14038008","","2011-01-01T00:00:00","393300","3026400","3419700","13860000","54296300","68156300"
"1687","58884","14038008","","2010-01-01T00:00:00","343200","2800800","3144000","12936000","49669700","62605700"
"1688","58884","14038008","","2009-01-01T00:00:00","429000","3303900","3732900","15246000","62057700","77303700"
"1689","58884","14038008","","2012-01-01T00:00:00","429000","3327300","3756300","16170000","60653200","76823200"
"1690","58884","14038008","01- Annual","2013-01-01T00:00:00","429000","3315400","3744400","16170000","62128000","78298000"
"1691","58884","14038008","","2008-01-01T00:00:00","429000","3226600","3655600","15246000","61703800","76949800"
"1692","58884","14038008","","2009-11-01T00:00:00","429000","3345200","3774200","15246000","59947500","75193500"
"1693","58908","06028028","01- Annual","2013-01-01T00:00:00","0","0","0","459500","0","459500"
"1694","58908","06028028","01- Annual","2018-01-01T00:00:00","31000","0","31000","813400","0","813400"
"1695","58908","06028028","01- Annual","2017-01-01T00:00:00","0","0","0","556700","0","556700"
"1696","58908","06028028","01- Annual","2016-01-01T00:00:00","0","0","0","536500","0","536500"
"1697","58908","06028028","01- Annual","2015-01-01T00:00:00","0","0","0","726800","0","726800"
"1698","58908","06028028","05- Review","2015-02-27T00:00:00","0","0","0","506500","0","506500"
"1699","58908","06028028","01- Annual","2014-01-01T00:00:00","0","0","0","459500","0","459500"
"1700","59638","18027013","01- Annual","2015-01-01T00:00:00","845300","4771800","5617100","19404000","90747000","110151000"
"1701","59638","18027013","01- Annual","2014-01-01T00:00:00","845300","3223700","4069000","17640000","86669200","104309200"
"1702","59638","18027013","01- Annual","2016-01-01T00:00:00","845300","4848700","5694000","20412000","90986500","111398500"
"1703","59638","18027013","01- Annual","2017-01-01T00:00:00","845300","4910600","5755900","21672000","94795300","116467300"
"1704","59638","18027013","03- Board of Equalization","2016-09-19T00:00:00","845300","4848700","5694000","20412000","90911100","111323100"
"1705","59638","18027013","01- Annual","2018-01-01T00:00:00","845300","4023900","4869200","21672000","93006500","114678500"
"1706","59638","18027013","03- Board of Equalization","2017-08-31T00:00:00","845300","3224000","4069300","21672000","94795300","116467300"
"1707","59638","18027013","","2008-01-01T00:00:00","845300","3048400","3893700","16632000","70997200","87629200"
"1708","59638","18027013","01- Annual","2013-01-01T00:00:00","845300","2814400","3659700","17640000","80895500","98535500"
"1709","59638","18027013","","2012-01-01T00:00:00","845300","2685700","3531000","15120000","81068300","96188300"
"1710","59638","18027013","","2009-01-01T00:00:00","845300","2879100","3724400","16632000","68374300","85006300"
"1711","59638","18027013","","2010-01-01T00:00:00","676300","2344800","3021100","14112000","57339900","71451900"
"1712","59638","18027013","","2011-01-01T00:00:00","774900","2511200","3286100","15120000","68203500","83323500"
"1713","59699","06026052","","2012-01-01T00:00:00","275000","1276000","1551000","1320000","6786500","8106500"
"1714","59699","06026052","01- Annual","2013-01-01T00:00:00","275000","1276000","1551000","1320000","6948200","8268200"
"1715","59699","06026052","01- Annual","2015-01-01T00:00:00","867000","1355400","2222400","1452000","8515800","9967800"
"1716","59699","06026052","01- Annual","2014-01-01T00:00:00","275000","1322100","1597100","1320000","7692700","9012700"
"1717","59718","29023007","","2008-01-01T00:00:00","2903500","9467300","12370800","16104000","65924600","82028600"
"1718","60209","14043031","","2008-01-01T00:00:00","158900","687300","846200","32934000","134722900","167656900"
"1719","60209","14043031","01- Annual","2013-01-01T00:00:00","576000","3064700","3640700","34930000","140106300","175036300"
"1720","60209","14043031","","2009-09-01T00:00:00","576000","3934800","4510800","32934000","134030600","166964600"
"1721","60209","14043031","","2008-11-01T00:00:00","158900","687300","846200","32934000","129322600","162256600"
"1722","60209","14043031","05- Review","2013-08-27T00:00:00","576000","3064700","3640700","34930000","139891000","174821000"
"1723","60209","14043031","","2012-01-01T00:00:00","576000","3590300","4166300","34930000","132334500","167264500"
"1724","60209","14043031","","2010-01-01T00:00:00","460800","3244500","3705300","27944000","113497200","141441200"
"1725","60209","14043031","","2009-01-01T00:00:00","576000","3934800","4510800","32934000","134495500","167429500"
"1726","60209","14043031","","2011-01-01T00:00:00","528000","3349300","3877300","27445000","128135500","155580500"
"1727","60209","14043031","01- Annual","2014-01-01T00:00:00","576000","3482900","4058900","34930000","151198200","186128200"
"1728","60209","14043031","01- Annual","2015-01-01T00:00:00","576000","4030600","4606600","38423000","143010000","181433000"
"1729","60209","14043031","03- Board of Equalization","2015-08-21T00:00:00","576000","4030600","4606600","38423000","138358500","176781500"
"1730","60209","14043031","01- Annual","2016-01-01T00:00:00","576000","4071200","4647200","40419000","142752800","183171800"
"1731","60209","14043031","03- Board of Equalization","2016-08-31T00:00:00","576000","4071200","4647200","40419000","140375300","180794300"
"1732","60209","14043031","01- Annual","2017-01-01T00:00:00","576000","4002800","4578800","42914000","139704300","182618300"
"1733","60209","14043031","03- Board of Equalization","2017-08-31T00:00:00","576000","4002800","4578800","42914000","137976400","180890400"
"1734","60209","14043031","01- Annual","2018-01-01T00:00:00","576000","3548900","4124900","42914000","144234400","187148400"
"1735","60248","29014016","01- Annual","2018-01-01T00:00:00","1218100","0","1218100","8408100","0","8408100"
"1736","60248","29014016","01- Annual","2017-01-01T00:00:00","1218100","1311700","2529800","10370000","41207300","51577300"
"1737","60248","29014016","03- Board of Equalization","2016-10-31T00:00:00","1218100","6300480","7518580","9809500","35190320","44999820"
"1738","60248","29014016","01- Annual","2016-01-01T00:00:00","1218100","7306700","8524800","9809500","41212700","51022200"
"1739","60248","29014016","03- Board of Equalization","2015-08-21T00:00:00","1216500","6095500","7312000","9237100","41396000","50633100"
"1740","60248","29014016","03- Board of Equalization","2014-12-12T00:00:00","1216500","6019100","7235600","8397400","39054200","47451600"
"1741","60248","29014016","01- Annual","2015-01-01T00:00:00","1216500","6095300","7311800","9237100","41396000","50633100"
"1742","60248","29014016","01- Annual","2014-01-01T00:00:00","1216500","6019100","7235600","8397400","39573200","47970600"
"1743","60248","29014016","","2011-01-01T00:00:00","1331900","7127900","8459800","10340000","46923600","57263600"
"1744","60248","29014016","","2009-01-01T00:00:00","1892800","5925100","7817900","12408000","48468000","60876000"
"1745","60248","29014016","","2010-01-01T00:00:00","1162400","6251600","7414000","10528000","36393000","46921000"
"1746","60248","29014016","","2012-01-01T00:00:00","1210800","7794500","9005300","11280200","48635600","59915800"
"1747","60248","29014016","","2011-08-01T00:00:00","1331900","7128500","8460400","10340000","44776900","55116900"
"1748","60248","29014016","05- Review","2013-10-31T00:00:00","1216500","6019200","7235700","8397400","37445100","45842500"
"1749","60248","29014016","01- Annual","2013-01-01T00:00:00","1216500","8283800","9500300","8397400","37445100","45842500"
"1750","60248","29014016","","2008-01-01T00:00:00","1892800","6171500","8064300","12408000","44757400","57165400"
"1751","60249","29014017","","2008-01-01T00:00:00","857300","2233300","3090600","2904000","7439800","10343800"
"1752","60249","29014017","01- Annual","2013-01-01T00:00:00","568000","3868000","4436000","3921100","17484700","21405800"
"1753","60249","29014017","05- Review","2013-10-31T00:00:00","568000","2810800","3378800","3921100","17484700","21405800"
"1754","60249","29014017","","2011-08-01T00:00:00","690000","3693100","4383100","2420000","10479700","12899700"
"1755","60249","29014017","","2012-01-01T00:00:00","627400","4038800","4666200","2640400","11384300","14024700"
"1756","60249","29014017","","2010-01-01T00:00:00","602200","3238800","3841000","2464000","8517500","10981500"
"1757","60249","29014017","","2009-01-01T00:00:00","857300","1987600","2844900","2904000","6617500","9521500"
"1758","60249","29014017","","2011-01-01T00:00:00","690000","3692700","4382700","2420000","10982100","13402100"
"1759","60249","29014017","01- Annual","2014-01-01T00:00:00","568000","2811100","3379100","3921100","18481700","22402800"
"1760","60249","29014017","01- Annual","2015-01-01T00:00:00","568000","2846700","3414700","4313200","19333000","23646200"
"1761","60249","29014017","03- Board of Equalization","2014-12-12T00:00:00","568000","2811100","3379100","3921100","17962700","21883800"
"1762","60249","29014017","01- Annual","2016-01-01T00:00:00","566100","3412400","3978500","4558900","19247300","23806200"
"1763","60249","29014017","03- Board of Equalization","2016-10-31T00:00:00","566100","2942400","3508500","4558900","16434700","20993600"
"1764","60249","29014017","01- Annual","2017-01-01T00:00:00","566100","612600","1178700","4819400","19244800","24064200"
"1765","60249","29014017","01- Annual","2018-01-01T00:00:00","566100","0","566100","3907600","0","3907600"
"1766","60250","29014018","01- Annual","2018-01-01T00:00:00","310600","0","310600","2144200","0","2144200"
"1767","60250","29014018","01- Annual","2017-01-01T00:00:00","310600","334500","645100","2644600","10509400","13154000"
"1768","60250","29014018","03- Board of Equalization","2016-10-31T00:00:00","310600","1606800","1917400","2501600","8974800","11476400"
"1769","60250","29014018","01- Annual","2016-01-01T00:00:00","310600","1863500","2174100","2501600","10510800","13012400"
"1770","60250","29014018","03- Board of Equalization","2014-12-12T00:00:00","310200","1535300","1845500","2141500","9573700","11715200"
"1771","60250","29014018","01- Annual","2015-01-01T00:00:00","310200","1554700","1864900","2355600","10557600","12913200"
"1772","60250","29014018","01- Annual","2014-01-01T00:00:00","310200","1535300","1845500","2141500","10092700","12234200"
"1773","60250","29014018","","2011-01-01T00:00:00","282300","1510800","1793100","495000","2246300","2741300"
"1774","60250","29014018","","2009-01-01T00:00:00","339500","787300","1126800","594000","1341400","1935400"
"1775","60250","29014018","","2010-01-01T00:00:00","246400","1325100","1571500","504000","1742200","2246200"
"1776","60250","29014018","","2012-01-01T00:00:00","256600","1651900","1908500","539400","2325500","2864900"
"1777","60250","29014018","","2011-08-01T00:00:00","282300","1511000","1793300","495000","2143600","2638600"
"1778","60250","29014018","05- Review","2013-10-31T00:00:00","310200","1535100","1845300","2141500","9549200","11690700"
"1779","60250","29014018","01- Annual","2013-01-01T00:00:00","310200","2112500","2422700","2141500","9549200","11690700"
"1780","60250","29014018","","2008-01-01T00:00:00","339500","884600","1224100","594000","1450100","2044100"
"1781","60290","14034013","","2008-01-01T00:00:00","271400","1939100","2210500","5610000","31765100","37375100"
"1782","60290","14034013","","2010-01-01T00:00:00","217100","1179400","1396500","4760000","23100000","27860000"
"1783","60290","14034013","","2009-01-01T00:00:00","271400","1816600","2088000","5610000","27295300","32905300"
"1784","60313","14030057","","2009-01-01T00:00:00","1734500","475600","2210100","0","0","0"
"1785","60313","14030057","","2010-01-01T00:00:00","1474300","475600","1949900","0","0","0"
"1786","60313","14030057","","2012-01-01T00:00:00","1474300","454000","1928300","0","0","0"
"1787","60313","14030057","","2011-01-01T00:00:00","1474300","454000","1928300","0","0","0"
"1788","60313","14030057","","2008-01-01T00:00:00","1734500","475600","2210100","0","0","0"
"1789","60313","14030057","01- Annual","2013-01-01T00:00:00","2100800","0","2100800","0","0","0"
"1790","60314","14030058","01- Annual","2013-01-01T00:00:00","9558100","0","9558100","0","0","0"
"1791","60314","14030058","","2008-01-01T00:00:00","827200","0","827200","6185500","0","6185500"
"1792","60314","14030058","","2011-01-01T00:00:00","758200","0","758200","5725700","0","5725700"
"1793","60314","14030058","","2012-01-01T00:00:00","827200","0","827200","6925700","0","6925700"
"1794","60314","14030058","","2010-01-01T00:00:00","661700","0","661700","5245700","0","5245700"
"1795","60314","14030058","","2009-01-01T00:00:00","827200","0","827200","6185500","0","6185500"
"1796","60399","06028031","","2009-01-01T00:00:00","276000","515600","791600","4884000","1541200","6425200"
"1797","60399","06028031","","2010-01-01T00:00:00","220800","923200","1144000","4144000","3471500","7615500"
"1798","60399","06028031","","2012-01-01T00:00:00","230000","1123500","1353500","4440000","6146400","10586400"
"1799","60399","06028031","","2011-01-01T00:00:00","211600","1055700","1267300","4070000","5167400","9237400"
"1800","60399","06028031","","2008-01-01T00:00:00","276000","605800","881800","4884000","2273600","7157600"
"1801","60399","06028031","01- Annual","2013-01-01T00:00:00","230000","1170200","1400200","4440000","6210700","10650700"
"1802","60399","06028031","01- Annual","2014-01-01T00:00:00","230000","1197100","1427100","4440000","5765000","10205000"
"1803","60399","06028031","01- Annual","2016-01-01T00:00:00","230000","1364900","1594900","5173700","4323500","9497200"
"1804","60399","06028031","05- Review","2015-02-27T00:00:00","230000","1584900","1814900","4884000","5793900","10677900"
"1805","60399","06028031","01- Annual","2015-01-01T00:00:00","199000","1344000","1543000","4663700","6861600","11525300"
"1806","60399","06028031","01- Annual","2017-01-01T00:00:00","230000","1496400","1726400","5476000","4723200","10199200"
"1807","60399","06028031","01- Annual","2018-01-01T00:00:00","199000","1705700","1904700","5219300","4236800","9456100"
"1808","60447","17010037","01- Annual","2018-01-01T00:00:00","11720700","38321500","50042200","19264000","71222600","90486600"
"1809","60447","17010037","05- Review","2017-09-21T00:00:00","11720700","37588000","49308700","19264000","60208400","79472400"
"1810","60447","17010037","05- Review","2015-09-09T00:00:00","11720700","31408500","43129200","17248000","66219800","83467800"
"1811","60447","17010037","01- Annual","2016-01-01T00:00:00","11720700","29979600","41700300","18144000","66479800","84623800"
"1812","60447","17010037","01- Annual","2017-01-01T00:00:00","11720700","46459800","58180500","19264000","64737000","84001000"
"1813","60447","17010037","03- Board of Equalization","2016-09-19T00:00:00","11720700","29979600","41700300","18144000","66229300","84373300"
"1814","60447","17010037","05- Review","2014-05-30T00:00:00","11720700","36037200","47757900","15680000","64034800","79714800"
"1815","60447","17010037","01- Annual","2015-01-01T00:00:00","11720700","36297100","48017800","17248000","66151100","83399100"
"1816","60447","17010037","01- Annual","2014-01-01T00:00:00","11720700","39988700","51709400","15680000","65162400","80842400"
"1817","60447","17010037","","2008-01-01T00:00:00","11720700","27981100","39701800","14784000","70876900","85660900"
"1818","60447","17010037","01- Annual","2013-01-01T00:00:00","11720700","31151000","42871700","15680000","56292500","71972500"
"1819","60447","17010037","","2011-01-01T00:00:00","10744000","32181800","42925800","13440000","44481100","57921100"
"1820","60447","17010037","","2012-01-01T00:00:00","11720700","31814600","43535300","15680000","49262400","64942400"
"1821","60447","17010037","","2010-09-01T00:00:00","9376600","25761000","35137600","12544000","50181400","62725400"
"1822","60447","17010037","","2010-01-01T00:00:00","11668600","25761000","37429600","12544000","50181400","62725400"
"1823","60447","17010037","","2009-01-01T00:00:00","11720700","28595300","40316000","14784000","67240500","82024500"
"1824","60799","14044021","","2009-01-01T00:00:00","343800","862900","1206700","17028000","42281400","59309400"
"1825","60799","14044021","","2010-01-01T00:00:00","275000","904700","1179700","14448000","61481700","75929700"
"1826","60799","14044021","","2010-09-01T00:00:00","275000","904700","1179700","14448000","57282700","71730700"
"1827","60799","14044021","","2012-01-01T00:00:00","343800","1049500","1393300","18060000","67710100","85770100"
"1828","60799","14044021","","2011-01-01T00:00:00","315200","919800","1235000","15480000","66273800","81753800"
"1829","60799","14044021","","2008-01-01T00:00:00","343800","862900","1206700","17028000","42281400","59309400"
"1830","60799","14044021","","2008-03-01T00:00:00","0","239700","239700","0","11744800","11744800"
"1831","62121","16018011","","2008-01-01T00:00:00","5390000","17068200","22458200","11849400","30943100","42792500"
"1832","62153","18024020","","2008-01-01T00:00:00","1405100","2939100","4344200","7524000","16654700","24178700"
"1833","62153","18024020","01- Annual","2013-01-01T00:00:00","1405100","7749900","9155000","6840000","46184900","53024900"
"1834","62153","18024020","","2008-11-01T00:00:00","0","86400","86400","0","489800","489800"
"1835","62153","18024020","","2011-01-01T00:00:00","1288000","5263700","6551700","6840000","38860100","45700100"
"1836","62153","18024020","","2012-01-01T00:00:00","1405100","8977800","10382900","6840000","46022100","52862100"
"1837","62153","18024020","","2010-01-01T00:00:00","1124100","4835200","5959300","6384000","35579100","41963100"
"1838","62153","18024020","","2009-01-01T00:00:00","1405100","2939100","4344200","7524000","16654700","24178700"
"1839","62153","18024020","01- Annual","2014-01-01T00:00:00","1405100","10026800","11431900","6840000","49787700","56627700"
"1840","62153","18024020","01- Annual","2015-01-01T00:00:00","1405100","8129300","9534400","8778000","48023400","56801400"
"1841","62153","18024020","05- Review","2014-11-04T00:00:00","1405100","8029400","9434500","6840000","49864500","56704500"
"1842","62153","18024020","01- Annual","2017-01-01T00:00:00","1405100","9176400","10581500","9804000","46191800","55995800"
"1843","62153","18024020","01- Annual","2016-01-01T00:00:00","1405100","8642600","10047700","9234000","48074500","57308500"
"1844","62153","18024020","03- Board of Equalization","2015-09-08T00:00:00","1405100","6966600","8371700","8778000","48023400","56801400"
"1845","62153","18024020","01- Annual","2018-01-01T00:00:00","1405100","9570500","10975600","9804000","47008200","56812200"
"1846","62153","18024020","03- Board of Equalization","2016-09-30T00:00:00","1405100","8642600","10047700","9234000","47777400","57011400"
"1847","62153","18024020","05- Review","2018-04-30T00:00:00","1405100","7365600","8770700","9804000","46306800","56110800"
"1848","62579","15070002","","2010-01-01T00:00:00","1535500","0","1535500","6496000","0","6496000"
"1849","63377","18084013","","2012-01-01T00:00:00","385000","2724600","3109600","6480000","12769500","19249500"
"1850","63377","18084013","","2009-01-01T00:00:00","462000","2362200","2824200","7128000","10741900","17869900"
"1851","63377","18084013","","2010-01-01T00:00:00","369600","1668200","2037800","6048000","8138600","14186600"
"1852","63377","18084013","","2011-01-01T00:00:00","354200","2544300","2898500","5940000","11777100","17717100"
"1853","63377","18084013","","2008-01-01T00:00:00","462000","2490600","2952600","7128000","11070800","18198800"
"1854","63377","18084013","01- Annual","2013-01-01T00:00:00","385000","2724600","3109600","6480000","11942600","18422600"
"1855","63377","18084013","","2008-01-01T00:00:00","462000","2490600","2952600","7128000","11070800","18198800"
"1856","63377","18084013","01- Annual","2018-01-01T00:00:00","385000","2652800","3037800","6480000","11912300","18392300"
"1857","63377","18084013","01- Annual","2016-01-01T00:00:00","385000","2759200","3144200","7560000","12450600","20010600"
"1858","63377","18084013","05- Review","2015-02-27T00:00:00","385000","2921800","3306800","7128000","13917600","21045600"
"1859","63377","18084013","01- Annual","2017-01-01T00:00:00","385000","2937200","3322200","7992000","11759200","19751200"
"1860","63377","18084013","01- Annual","2015-01-01T00:00:00","385000","3061100","3446100","7128000","14615800","21743800"
"1861","63377","18084013","01- Annual","2014-01-01T00:00:00","385000","2893600","3278600","6480000","12924300","19404300"
"1862","63380","31025113","","2008-01-01T00:00:00","348000","20000","368000","2400000","0","2400000"
"1863","63380","31025113","","2009-01-01T00:00:00","261000","20000","281000","1500000","0","1500000"
"1864","63680","34027062","01- Annual","2009-01-01T00:00:00","856500","0","856500","24306200","0","24306200"
"1865","63680","34027062","01- Annual","2010-01-01T00:00:00","775500","0","775500","23342600","0","23342600"
"1866","63680","34027062","01- Annual","2012-01-01T00:00:00","973600","0","973600","29303100","0","29303100"
"1867","63680","34027062","01- Annual","2011-01-01T00:00:00","890600","0","890600","25065000","0","25065000"
"1868","63680","34027062","01- Annual","2008-01-01T00:00:00","841600","0","841600","23884700","0","23884700"
"1869","63680","34027062","01- Annual","2013-01-01T00:00:00","973600","0","973600","29303100","0","29303100"
"1870","63680","34027062","05- Review","2013-10-23T00:00:00","976300","0","976300","24847400","0","24847400"
"1871","63680","34027062","05- Review","2012-10-23T00:00:00","973000","0","973000","24763300","0","24763300"
"1872","63680","34027062","05- Review","2011-10-23T00:00:00","890100","0","890100","21180800","0","21180800"
"1873","63680","34027062","05- Review","2010-10-23T00:00:00","775000","0","775000","19723300","0","19723300"
"1874","63680","34027062","01- Annual","2014-01-01T00:00:00","973600","0","973600","24777300","0","24777300"
"1875","63680","34027062","03- Board of Equalization","2014-08-20T00:00:00","973600","0","973600","21177300","0","21177300"
"1876","63680","34027062","01- Annual","2016-01-01T00:00:00","822600","0","822600","25121400","0","25121400"
"1877","63680","34027062","01- Annual","2015-01-01T00:00:00","822500","0","822500","23684500","0","23684500"
"1878","63680","34027062","01- Annual","2018-01-01T00:00:00","822500","0","822500","21531000","0","21531000"
"1879","63680","34027062","01- Annual","2017-01-01T00:00:00","822700","0","822700","26560100","0","26560100"
"1880","63681","34027063","03- Board of Equalization","2016-07-20T00:00:00","206500","1315300","1521800","26377500","101132300","127509800"
"1881","63681","34027063","03- Board of Equalization","2017-07-01T00:00:00","206500","1382900","1589400","27888100","97105400","124993500"
"1882","63681","34027063","01- Annual","2016-01-01T00:00:00","206500","1406600","1613100","26377500","103125300","129502800"
"1883","63681","34027063","03- Board of Equalization","2015-09-28T00:00:00","206500","1178313","1384813","24868800","103976087","128844887"
"1884","63681","34027063","01- Annual","2017-01-01T00:00:00","206500","1382900","1589400","27888100","99708100","127596200"
"1885","63681","34027063","05- Review","2014-03-27T00:00:00","244400","1150400","1394800","26016200","97183000","123199200"
"1886","63681","34027063","01- Annual","2015-01-01T00:00:00","206500","1260000","1466500","24868800","104179500","129048300"
"1887","63681","34027063","01- Annual","2014-01-01T00:00:00","244400","1150400","1394800","26016200","97261800","123278000"
"1888","63681","34027063","","2008-11-01T00:00:00","248600","1291800","1540400","24948000","79689200","104637200"
"1889","63681","34027063","","2008-01-01T00:00:00","248600","1604800","1853400","24948000","99062200","124010200"
"1890","63681","34027063","01- Annual","2013-01-01T00:00:00","244400","1150400","1394800","26960400","91860100","118820500"
"1891","63681","34027063","","2011-01-01T00:00:00","223600","1805600","2029200","23061100","94938700","117999800"
"1892","63681","34027063","","2012-01-01T00:00:00","248600","1522500","1771100","26960400","89189800","116150200"
"1893","63681","34027063","","2010-10-01T00:00:00","194700","1670900","1865600","21476000","84338000","105814000"
"1894","63681","34027063","","2010-01-01T00:00:00","194700","2470400","2665100","21476000","94164400","115640400"
"1895","63681","34027063","","2009-01-01T00:00:00","248600","1644000","1892600","24948000","103915000","128863000"
"1896","63681","34027063","","2009-09-01T00:00:00","248600","1548200","1796800","24948000","95190500","120138500"
"1897","63683","34027065","01- Annual","2009-01-01T00:00:00","823500","0","823500","22746700","0","22746700"
"1898","63683","34027065","01- Annual","2010-01-01T00:00:00","745700","0","745700","21844900","0","21844900"
"1899","63683","34027065","01- Annual","2012-01-01T00:00:00","936100","0","936100","27423000","0","27423000"
"1900","63683","34027065","01- Annual","2011-01-01T00:00:00","856300","0","856300","23456800","0","23456800"
"1901","63683","34027065","01- Annual","2008-01-01T00:00:00","809300","0","809300","22352200","0","22352200"
"1902","63683","34027065","05- Review","2013-10-23T00:00:00","938800","0","938800","22845800","0","22845800"
"1903","63683","34027065","05- Review","2012-10-23T00:00:00","935600","0","935600","22768500","0","22768500"
"1904","63683","34027065","05- Review","2011-10-23T00:00:00","855800","0","855800","19474600","0","19474600"
"1905","63683","34027065","05- Review","2010-10-23T00:00:00","745200","0","745200","18134500","0","18134500"
"1906","63683","34027065","01- Annual","2013-01-01T00:00:00","936100","0","936100","27423000","0","27423000"
"1907","63683","34027065","01- Annual","2014-01-01T00:00:00","936100","0","936100","22781400","0","22781400"
"1908","63683","34027065","03- Board of Equalization","2014-08-20T00:00:00","936100","0","936100","19471400","0","19471400"
"1909","63683","34027065","01- Annual","2016-01-01T00:00:00","790900","0","790900","23097700","0","23097700"
"1910","63683","34027065","01- Annual","2015-01-01T00:00:00","790900","0","790900","21776600","0","21776600"
"1911","63683","34027065","01- Annual","2018-01-01T00:00:00","790900","0","790900","19796600","0","19796600"
"1912","63683","34027065","01- Annual","2017-01-01T00:00:00","791000","0","791000","24420500","0","24420500"
"1913","64730","17003583","01- Annual","2017-01-01T00:00:00","0","0","0","6692600","51742600","58435200"
"1914","64730","17003583","01- Annual","2018-01-01T00:00:00","0","0","0","5842400","60111400","65953800"
"1915","64730","17003583","01- Annual","2016-01-01T00:00:00","0","0","0","6303500","56277900","62581400"
"1916","64730","17003583","05- Review","2016-08-17T00:00:00","0","0","0","6303500","52940600","59244100"
"1917","64730","17003583","01- Annual","2015-01-01T00:00:00","0","0","0","16496000","55935100","72431100"
"1918","64730","17003583","03- Board of Equalization","2014-09-29T00:00:00","0","0","0","15005500","55881300","70886800"
"1919","64730","17003583","01- Annual","2014-01-01T00:00:00","0","0","0","15005500","55941700","70947200"
"1920","64730","17003583","01- Annual","2013-01-01T00:00:00","0","0","0","15005500","53418200","68423700"
"1921","64730","17003583","","2011-01-01T00:00:00","0","0","0","12857600","47510700","60368300"
"1922","64730","17003583","","2012-01-01T00:00:00","0","0","0","15005500","54535300","69540800"
"1923","64730","17003583","","2010-01-01T00:00:00","0","0","0","11997400","46857900","58855300"
"1924","65005","34027453","01- Annual","2013-01-01T00:00:00","0","0","0","14840000","54418900","69258900"
"1925","65311","32006028","","2008-01-01T00:00:00","2541000","1970300","4511300","16962000","13186200","30148200"
"1926","65311","32006028","","2009-01-01T00:00:00","2760000","10540000","13300000","17754000","74032700","91786700"
"1927","65311","32006028","","2009-11-01T00:00:00","1601600","6116200","7717800","17754000","64822800","82576800"
"1928","65611","14041187","","2009-04-01T00:00:00","0","0","0","0","10152900","10152900"
"1929","65611","14041187","","2009-01-01T00:00:00","249500","0","249500","7128000","16545700","23673700"
"1930","65611","14041187","","2010-01-01T00:00:00","199600","830200","1029800","6048000","22172500","28220500"
"1931","65611","14041187","","2012-01-01T00:00:00","249500","1491700","1741200","7560000","35178000","42738000"
"1932","65611","14041187","","2011-01-01T00:00:00","228700","891500","1120200","6480000","24216000","30696000"
"1933","65611","14041187","","2008-01-01T00:00:00","249500","0","249500","7128000","0","7128000"
"1934","65611","14041187","01- Annual","2013-01-01T00:00:00","249500","1773300","2022800","7560000","34188500","41748500"
"1935","65611","14041187","01- Annual","2014-01-01T00:00:00","249500","1828000","2077500","7560000","36507800","44067800"
"1936","65611","14041187","03- Board of Equalization","2014-08-29T00:00:00","249500","1684500","1934000","7560000","33364300","40924300"
"1937","65611","14041187","01- Annual","2015-01-01T00:00:00","249500","1640600","1890100","8316000","36936600","45252600"
"1938","65611","14041187","03- Board of Equalization","2016-08-31T00:00:00","249500","1721900","1971400","8748000","31494100","40242100"
"1939","65611","14041187","01- Annual","2017-01-01T00:00:00","249500","1878000","2127500","9288000","30011900","39299900"
"1940","65611","14041187","03- Board of Equalization","2015-08-21T00:00:00","249500","1640600","1890100","8316000","32367900","40683900"
"1941","65611","14041187","01- Annual","2016-01-01T00:00:00","249500","1772500","2022000","8748000","32527900","41275900"
"1942","65611","14041187","03- Board of Equalization","2017-08-31T00:00:00","249500","1878000","2127500","9288000","28405400","37693400"
"1943","65611","14041187","01- Annual","2018-01-01T00:00:00","249500","1762300","2011800","9288000","30448600","39736600"
"1944","65751","25017098","01- Annual","2018-01-01T00:00:00","2449600","15416000","17865600","11280000","50177200","61457200"
"1945","65751","25017098","01- Annual","2016-01-01T00:00:00","2449600","13516700","15966300","13160000","46799000","59959000"
"1946","65751","25017098","01- Annual","2017-01-01T00:00:00","2449600","14470100","16919700","13912000","46698800","60610800"
"1947","65751","25017098","01- Annual","2015-01-01T00:00:00","2449600","9804900","12254500","12408000","52893000","65301000"
"1948","65751","25017098","05- Review","2014-07-08T00:00:00","2449600","12245800","14695400","11280000","48186900","59466900"
"1949","65751","25017098","01- Annual","2014-01-01T00:00:00","2449600","13245600","15695200","11280000","52775300","64055300"
"1950","65751","25017098","01- Annual","2013-01-01T00:00:00","2449600","12397200","14846800","11280000","48727800","60007800"
"1951","65751","25017098","","2008-01-01T00:00:00","2939500","0","2939500","12408000","0","12408000"
"1952","65751","25017098","","2011-01-01T00:00:00","2253600","11668000","13921600","10340000","43203800","53543800"
"1953","65751","25017098","","2012-01-01T00:00:00","2449600","9106200","11555800","11280000","46129700","57409700"
"1954","65751","25017098","","2012-07-01T00:00:00","2449600","13142100","15591700","11280000","50511600","61791600"
"1955","65751","25017098","","2010-01-01T00:00:00","2351600","10447300","12798900","10528000","38697800","49225800"
"1956","65751","25017098","","2009-01-01T00:00:00","2939500","0","2939500","12408000","0","12408000"
"1957","65936","31025114","","2009-01-01T00:00:00","0","1554500","1554500","0","2024000","2024000"
"1958","65936","31025114","","2010-01-01T00:00:00","0","1321100","1321100","0","1681300","1681300"
"1959","65936","31025114","","2012-01-01T00:00:00","0","1255500","1255500","0","2530700","2530700"
"1960","65936","31025114","","2011-01-01T00:00:00","0","1194500","1194500","0","2313800","2313800"
"1961","65936","31025114","","2008-01-01T00:00:00","0","1135400","1135400","0","1436200","1436200"
"1962","66462","14035022","01- Annual","2013-01-01T00:00:00","41200","0","41200","2004100","0","2004100"
"1963","66463","14035023","01- Annual","2013-01-01T00:00:00","20600","0","20600","1002000","0","1002000"
"1964","66464","14035024","01- Annual","2013-01-01T00:00:00","20600","0","20600","1002000","0","1002000"
"1965","66465","14035025","01- Annual","2013-01-01T00:00:00","20600","0","20600","1002000","0","1002000"
"1966","66470","18013011","01- Annual","2013-01-01T00:00:00","7314700","37917200","45231900","17080000","75842200","92922200"
"1967","66470","18013011","","2011-01-01T00:00:00","6705200","30056300","36761500","14640000","60748300","75388300"
"1968","66470","18013011","","2012-01-01T00:00:00","7314700","38765700","46080400","17080000","69339000","86419000"
"1969","66470","18013011","","2010-10-01T00:00:00","0","3381800","3381800","0","6564700","6564700"
"1970","66470","18013011","","2010-01-01T00:00:00","5851800","8596400","14448200","13664000","16836800","30500800"
"1971","66470","18013011","","2009-01-01T00:00:00","7314700","0","7314700","16104000","0","16104000"
"1972","66470","18013011","01- Annual","2014-01-01T00:00:00","7314700","39919000","47233700","17080000","82282400","99362400"
"1973","66470","18013011","01- Annual","2015-01-01T00:00:00","7314700","57691600","65006300","18788000","82645400","101433400"
"1974","66470","18013011","01- Annual","2017-01-01T00:00:00","7314700","61805800","69120500","20984000","85392500","106376500"
"1975","66470","18013011","01- Annual","2016-01-01T00:00:00","7314700","58501800","65816500","19764000","82502600","102266600"
"1976","66470","18013011","01- Annual","2018-01-01T00:00:00","7314700","56891500","64206200","20984000","90458100","111442100"
"1977","66878","11012029","","2009-01-01T00:00:00","389400","0","389400","14124000","3662100","17786100"
"1978","66878","11012029","","2010-01-01T00:00:00","311500","0","311500","11984000","28572300","40556300"
"1980","66954","31022101","01- Annual","2017-01-01T00:00:00","70700","229900","300600","4172500","8237300","12409800"
"1981","66954","31022101","01- Annual","2015-01-01T00:00:00","70700","397200","467900","6204000","8258100","14462100"
"1982","66954","31022101","01- Annual","2016-01-01T00:00:00","70700","366300","437000","4350700","8179200","12529900"
"1983","66954","31022101","01- Annual","2014-01-01T00:00:00","70700","409200","479900","5640000","8380600","14020600"
"1984","66954","31022101","","2009-01-01T00:00:00","84800","0","84800","6204000","1000","6205000"
"1985","66954","31022101","","2010-01-01T00:00:00","67800","0","67800","5264000","1000","5265000"
"1986","66954","31022101","","2012-01-01T00:00:00","70700","0","70700","5640000","1000","5641000"
"1987","66954","31022101","","2011-01-01T00:00:00","65000","0","65000","5170000","1000","5171000"
"1988","66954","31022101","01- Annual","2013-01-01T00:00:00","70700","0","70700","5640000","790400","6430400"
"1989","66960","32024004","01- Annual","2013-01-01T00:00:00","0","0","0","0","52981600","52981600"
"1990","66960","32024004","","2011-01-01T00:00:00","0","0","0","0","48960000","48960000"
"1991","66960","32024004","","2012-01-01T00:00:00","0","0","0","0","52981600","52981600"
"1992","66960","32024004","","2010-08-01T00:00:00","0","0","0","0","45034400","45034400"
"1993","66960","32024004","","2010-01-01T00:00:00","0","0","0","0","42359100","42359100"
"1994","66962","31022102","","2010-01-01T00:00:00","0","127800","127800","0","6584000","6584000"
"1995","66962","31022102","","2012-01-01T00:00:00","0","123000","123000","0","7528300","7528300"
"1996","66962","31022102","","2011-01-01T00:00:00","0","115300","115300","0","6048300","6048300"
"1997","66962","31022102","01- Annual","2013-01-01T00:00:00","0","137700","137700","0","8235500","8235500"
"1998","66975","16038014","01- Annual","2013-01-01T00:00:00","437500","0","437500","5321100","0","5321100"
"1999","66975","16038014","","2011-01-01T00:00:00","342900","0","342900","4560900","0","4560900"
"2000","66975","16038014","","2012-01-01T00:00:00","374000","0","374000","5321100","0","5321100"
"2001","66975","16038014","","2010-01-01T00:00:00","299200","0","299200","4256900","0","4256900"
"2002","66975","16038014","01- Annual","2015-01-01T00:00:00","415100","0","415100","5933900","0","5933900"
"2003","66975","16038014","01- Annual","2014-01-01T00:00:00","437500","0","437500","5685900","0","5685900"
"2004","66975","16038014","01- Annual","2016-01-01T00:00:00","415100","0","415100","6242100","0","6242100"
"2005","66975","16038014","01- Annual","2017-01-01T00:00:00","415100","0","415100","6627500","0","6627500"
"2006","66975","16038014","09- New Construction","2017-05-01T00:00:00","415100","812300","1227400","6627500","13026000","19653500"
"2007","66975","16038014","01- Annual","2018-01-01T00:00:00","415100","2825900","3241000","6627500","31533700","38161200"
"2008","66976","16038015","01- Annual","2018-01-01T00:00:00","1599400","10631000","12230400","25536600","118627000","144163600"
"2009","66976","16038015","05- Review","2017-10-31T00:00:00","1599400","3056000","4655400","25536600","49002700","74539300"
"2010","66976","16038015","01- Annual","2017-01-01T00:00:00","1599400","0","1599400","25536600","0","25536600"
"2011","66976","16038015","01- Annual","2016-01-01T00:00:00","1599400","0","1599400","24051900","0","24051900"
"2012","66976","16038015","01- Annual","2014-01-01T00:00:00","1577000","0","1577000","20494100","0","20494100"
"2013","66976","16038015","01- Annual","2015-01-01T00:00:00","1599400","0","1599400","22864100","0","22864100"
"2014","66976","16038015","","2010-01-01T00:00:00","1078600","0","1078600","15343100","0","15343100"
"2015","66976","16038015","","2012-01-01T00:00:00","1348200","0","1348200","19178900","0","19178900"
"2016","66976","16038015","","2011-01-01T00:00:00","1235800","0","1235800","16439100","0","16439100"
"2017","66976","16038015","01- Annual","2013-01-01T00:00:00","1577000","0","1577000","19178900","0","19178900"
"2018","66989","25016012","01- Annual","2013-01-01T00:00:00","4313800","26503800","30817600","15666600","74463400","90130000"
"2019","66989","25016012","","2011-01-01T00:00:00","3991800","0","3991800","14705400","0","14705400"
"2020","66989","25016012","","2012-01-01T00:00:00","4313900","23869500","28183400","15666600","69525000","85191600"
"2021","66989","25016012","","2011-06-01T00:00:00","0","4888700","4888700","0","30030800","30030800"
"2022","66989","25016012","","2010-01-01T00:00:00","4165300","0","4165300","14972700","0","14972700"
"2023","66989","25016012","01- Annual","2015-01-01T00:00:00","4313800","24576300","28890100","17233300","75227200","92460500"
"2024","66989","25016012","05- Review","2013-08-29T00:00:00","4313900","20995000","25308900","15666600","73373400","89040000"
"2025","66989","25016012","01- Annual","2014-01-01T00:00:00","4313800","24832800","29146600","15666600","76847800","92514400"
"2026","66989","25016012","05- Review","2014-05-08T00:00:00","4313800","21558200","25872000","15666600","74003700","89670300"
"2027","66989","25016012","01- Annual","2016-01-01T00:00:00","4313800","23450200","27764000","18277800","65638900","83916700"
"2028","66989","25016012","05- Review","2015-06-05T00:00:00","4313800","22578300","26892100","17695300","70779500","88474800"
"2029","66989","25016012","01- Annual","2017-01-01T00:00:00","4313800","29371600","33685400","19322200","66993500","86315700"
"2030","66989","25016012","05- Review","2017-09-18T00:00:00","4313900","26236700","30550600","19322200","63978700","83300900"
"2031","66989","25016012","01- Annual","2018-01-01T00:00:00","4313800","0","4313800","15666600","0","15666600"
"2032","66989","25016012","05- Review","2018-02-16T00:00:00","4313800","26521700","30835500","15666600","68082500","83749100"
"2033","66990","25016013","01- Annual","2018-01-01T00:00:00","494200","0","494200","1794900","0","1794900"
"2034","66990","25016013","01- Annual","2017-01-01T00:00:00","494200","0","494200","2213700","0","2213700"
"2035","66990","25016013","01- Annual","2016-01-01T00:00:00","494200","0","494200","2094100","0","2094100"
"2036","66990","25016013","01- Annual","2015-01-01T00:00:00","494200","0","494200","1974400","0","1974400"
"2037","66990","25016013","01- Annual","2014-01-01T00:00:00","494200","0","494200","1794900","0","1794900"
"2038","66990","25016013","","2010-01-01T00:00:00","477200","0","477200","1715400","0","1715400"
"2039","66990","25016013","","2012-07-01T00:00:00","494200","0","494200","1794900","0","1794900"
"2040","66990","25016013","","2012-01-01T00:00:00","494200","0","494200","1794900","0","1794900"
"2041","66990","25016013","","2011-01-01T00:00:00","457300","0","457300","1684800","0","1684800"
"2042","66990","25016013","01- Annual","2013-01-01T00:00:00","494200","0","494200","1794900","0","1794900"
"2043","66991","25016014","01- Annual","2013-01-01T00:00:00","16100","0","16100","58400","0","58400"
"2044","66991","25016014","","2011-01-01T00:00:00","14900","0","14900","54900","0","54900"
"2045","66991","25016014","","2012-01-01T00:00:00","16100","0","16100","58400","0","58400"
"2046","66991","25016014","","2012-07-01T00:00:00","16100","0","16100","58400","0","58400"
"2047","66991","25016014","","2010-01-01T00:00:00","15500","0","15500","55800","0","55800"
"2048","66991","25016014","01- Annual","2014-01-01T00:00:00","16100","0","16100","58400","0","58400"
"2049","66991","25016014","01- Annual","2015-01-01T00:00:00","16100","0","16100","64300","0","64300"
"2050","66991","25016014","01- Annual","2016-01-01T00:00:00","16100","0","16100","68200","0","68200"
"2051","66991","25016014","01- Annual","2017-01-01T00:00:00","16100","0","16100","72100","0","72100"
"2052","66991","25016014","01- Annual","2018-01-01T00:00:00","16100","0","16100","58400","0","58400"
"2053","66996","32006031","01- Annual","2018-01-01T00:00:00","485300","7761500","8246800","4520000","0","4520000"
"2054","66997","32006032","01- Annual","2018-01-01T00:00:00","0","970200","970200","0","0","0"
"2055","66998","32006033","01- Annual","2018-01-01T00:00:00","0","970200","970200","0","0","0"
"2056","66999","32006034","01- Annual","2018-01-01T00:00:00","1247600","0","1247600","11620000","80040000","91660000"
"2057","67000","32006035","01- Annual","2018-01-01T00:00:00","0","0","0","0","1643400","1643400"
"2058","67062","28004212","01- Annual","2018-01-01T00:00:00","377200","1534800","1912000","14040000","60064800","74104800"
"2059","67062","28004212","03- Board of Equalization","2015-11-03T00:00:00","377200","1582970","1960170","15444000","53703230","69147230"
"2060","67062","28004212","01- Annual","2017-01-01T00:00:00","377200","1552200","1929400","17316000","49690500","67006500"
"2061","67062","28004212","03- Board of Equalization","2016-06-30T00:00:00","377200","1613200","1990400","16380000","50798500","67178500"
"2062","67062","28004212","01- Annual","2016-01-01T00:00:00","377200","1613200","1990400","16380000","54443100","70823100"
"2063","67062","28004212","01- Annual","2015-01-01T00:00:00","377200","2789500","3166700","15444000","56641700","72085700"
"2064","67062","28004212","01- Annual","2014-01-01T00:00:00","377200","2362200","2739400","14040000","58234300","72274300"
"2065","67062","28004212","","2010-01-01T00:00:00","362100","1583200","1945300","13160000","52029200","65189200"
"2066","67062","28004212","","2012-07-01T00:00:00","377200","1815700","2192900","14040000","53232900","67272900"
"2067","67062","28004212","","2012-11-01T00:00:00","377200","1937700","2314900","14040000","48350800","62390800"
"2068","67062","28004212","","2012-01-01T00:00:00","377200","1937700","2314900","14040000","48350800","62390800"
"2069","67062","28004212","","2011-01-01T00:00:00","347000","1741100","2088100","12925000","58589100","71514100"
"2070","67062","28004212","01- Annual","2013-01-01T00:00:00","377200","1857000","2234200","14040000","55308500","69348500"
"2071","67117","34020268","01- Annual","2013-01-01T00:00:00","93800","277100","370900","18550000","68277100","86827100"
"2072","67117","34020268","","2011-01-01T00:00:00","86000","255500","341500","15900000","63773900","79673900"
"2073","67117","34020268","","2012-01-01T00:00:00","93800","273100","366900","18550000","67343500","85893500"
"2074","67117","34020268","","2010-01-01T00:00:00","75000","222000","297000","14840000","53742400","68582400"
"2075","67117","34020268","01- Annual","2014-01-01T00:00:00","93800","314200","408000","18550000","68626000","87176000"
"2076","67117","34020268","01- Annual","2015-01-01T00:00:00","93800","400200","494000","20405000","83188600","103593600"
"2077","67117","34020268","01- Annual","2016-01-01T00:00:00","93800","400500","494300","21465000","82199200","103664200"
"2078","67117","34020268","01- Annual","2018-01-01T00:00:00","93800","446400","540200","22790000","92395000","115185000"
"2079","67117","34020268","01- Annual","2017-01-01T00:00:00","93800","505800","599600","22790000","88100600","110890600"
"2080","67408","31025115","01- Annual","2017-01-01T00:00:00","115000","241500","356500","2043500","2888800","4932300"
"2081","67408","31025115","05- Review","2017-03-21T00:00:00","115000","105900","220900","2043500","2804700","4848200"
"2082","67408","31025115","01- Annual","2018-01-01T00:00:00","115000","163200","278200","2160000","3017500","5177500"
"2083","67408","31025115","01- Annual","2016-01-01T00:00:00","115000","215200","330200","1946200","2688300","4634500"
"2084","67408","31025115","05- Review","2015-03-13T00:00:00","115000","140400","255400","2376000","3087100","5463100"
"2085","67408","31025115","01- Annual","2015-01-01T00:00:00","115000","242700","357700","2376000","3348700","5724700"
"2086","67408","31025115","01- Annual","2014-01-01T00:00:00","115000","195800","310800","2160000","2702500","4862500"
"2087","67408","31025115","","2010-01-01T00:00:00","110400","0","110400","2016000","0","2016000"
"2088","67408","31025115","","2012-01-01T00:00:00","115000","0","115000","2160000","20000","2180000"
"2089","67408","31025115","","2011-06-01T00:00:00","0","159700","159700","0","2501200","2501200"
"2090","67408","31025115","","2011-01-01T00:00:00","105800","0","105800","1980000","0","1980000"
"2091","67408","31025115","01- Annual","2013-01-01T00:00:00","115000","0","115000","2160000","213000","2373000"
"2092","67415","31025116","","2011-01-01T00:00:00","266800","20000","286800","675000","0","675000"
"2093","67415","31025116","","2012-01-01T00:00:00","290000","20000","310000","1500000","0","1500000"
"2094","67415","31025116","","2010-01-01T00:00:00","124800","20000","144800","672100","0","672100"
"2095","67416","31025117","","2010-01-01T00:00:00","153600","0","153600","827900","0","827900"
"2096","67416","31025117","","2011-01-01T00:00:00","0","0","0","825000","0","825000"
"2097","67419","14060069","","2011-01-01T00:00:00","489500","0","489500","11880000","0","11880000"
"2098","67419","14060069","","2010-01-01T00:00:00","427200","0","427200","11088000","0","11088000"
"2099","67419","14060069","","2010-12-01T00:00:00","18700","0","18700","486100","0","486100"
"2100","67420","14060070","","2010-01-01T00:00:00","96000","0","96000","9184000","0","9184000"
"2101","67427","22001723","","2010-01-01T00:00:00","144000","0","144000","10752000","0","10752000"
"2102","67439","15070003","","2010-01-01T00:00:00","990000","254100","1244100","6496000","0","6496000"
"2103","67439","15070003","","2012-01-01T00:00:00","0","0","0","8120000","13278300","21398300"
"2104","67439","15070003","","2011-01-01T00:00:00","1134400","253700","1388100","6960000","0","6960000"
"2105","67440","15070004","","2011-01-01T00:00:00","2321400","3741800","6063200","0","0","0"
"2106","67440","15070004","","2012-01-01T00:00:00","2532500","3951200","6483700","0","0","0"
"2107","67440","15070004","01- Annual","2013-01-01T00:00:00","2532500","3951200","6483700","0","0","0"
"2108","67440","15070004","01- Annual","2014-01-01T00:00:00","2532500","3951200","6483700","0","0","0"
"2109","67527","14060078","","2011-05-01T00:00:00","110000","0","110000","9840000","0","9840000"
"2110","67527","14060078","","2011-06-22T00:00:00","51900","0","51900","4636900","0","4636900"
"2111","67538","11012030","","2012-01-01T00:00:00","201500","882200","1083700","0","0","0"
"2112","67538","11012030","","2011-01-01T00:00:00","185400","918600","1104000","0","0","0"
"2113","67538","11012030","01- Annual","2013-01-01T00:00:00","201500","871800","1073300","0","0","0"
"2114","67538","11012030","05- Review","2013-09-12T00:00:00","201500","871100","1072600","0","0","0"
"2115","67538","11012030","01- Annual","2014-01-01T00:00:00","201500","931100","1132600","0","0","0"
"2116","67538","11012030","01- Annual","2015-04-01T00:00:00","9600","919000","928600","418200","0","418200"
"2117","67538","11012030","01- Annual","2015-01-01T00:00:00","9600","919000","928600","418200","0","418200"
"2118","67538","11012030","01- Annual","2016-01-01T00:00:00","9600","1064700","1074300","443500","0","443500"
"2119","67538","11012030","01- Annual","2017-01-01T00:00:00","9600","1078500","1088100","468900","0","468900"
"2120","67538","11012030","01- Annual","2018-01-01T00:00:00","9600","0","9600","380200","0","380200"
"2121","67539","11012031","01- Annual","2018-01-01T00:00:00","6000","0","6000","237600","0","237600"
"2122","67539","11012031","01- Annual","2017-01-01T00:00:00","6000","661000","667000","293100","0","293100"
"2123","67539","11012031","01- Annual","2016-01-01T00:00:00","6000","652600","658600","277200","0","277200"
"2124","67539","11012031","01- Annual","2015-01-01T00:00:00","6000","563200","569200","261400","0","261400"
"2125","67539","11012031","01- Annual","2014-01-01T00:00:00","123500","570600","694100","0","0","0"
"2126","67539","11012031","05- Review","2013-09-12T00:00:00","123500","533900","657400","0","0","0"
"2127","67539","11012031","01- Annual","2013-01-01T00:00:00","123500","534400","657900","0","0","0"
"2128","67539","11012031","","2011-01-01T00:00:00","113600","563000","676600","0","0","0"
"2129","67539","11012031","","2012-01-01T00:00:00","123500","540700","664200","0","0","0"
"2130","67540","11012032","","2012-01-01T00:00:00","0","0","0","12840000","86248500","99088500"
"2131","67540","11012032","","2011-01-01T00:00:00","0","0","0","11770000","82131200","93901200"
"2132","67540","11012032","01- Annual","2013-01-01T00:00:00","0","0","0","12840000","90503200","103343200"
"2133","67540","11012032","05- Review","2013-09-12T00:00:00","0","0","0","12840000","84553000","97393000"
"2134","67540","11012032","01- Annual","2014-01-01T00:00:00","0","0","0","12840000","83107200","95947200"
"2135","67540","11012032","01- Annual","2015-01-01T00:00:00","309400","0","309400","13444400","82542800","95987200"
"2136","67540","11012032","03- Board of Equalization","2015-08-21T00:00:00","309400","0","309400","13444400","81947900","95392300"
"2137","67540","11012032","01- Annual","2016-01-01T00:00:00","309400","0","309400","14259200","84400900","98660100"
"2138","67540","11012032","01- Annual","2017-01-01T00:00:00","309400","0","309400","15074000","84625200","99699200"
"2139","67540","11012032","01- Annual","2018-01-01T00:00:00","309400","0","309400","12222200","0","12222200"
"2140","67563","17011058","01- Annual","2014-01-01T00:00:00","114100","178000","292100","1447600","1800100","3247700"
"2141","67563","17011058","01- Annual","2013-01-01T00:00:00","114100","0","114100","1447600","216600","1664200"
"2142","67563","17011058","","2011-01-01T00:00:00","121000","0","121000","1060100","0","1060100"
"2143","67563","17011058","","2012-01-01T00:00:00","131300","0","131300","1230400","0","1230400"
"2144","67746","14060080","","2012-01-01T00:00:00","542100","0","542100","17920000","0","17920000"
"2145","67746","14060080","03- Board of Equalization","2015-09-28T00:00:00","542100","3203929","3746029","19789000","72877171","92666171"
"2146","67746","14060080","01- Annual","2015-01-01T00:00:00","542100","3297300","3839400","19789000","75186900","94975900"
"2147","67746","14060080","01- Annual","2016-01-01T00:00:00","542100","3458100","4000200","20817000","75383700","96200700"
"2148","67746","14060080","03- Board of Equalization","2017-10-31T00:00:00","542100","3176200","3718300","22102000","76399800","98501800"
"2149","67746","14060080","01- Annual","2018-01-01T00:00:00","542100","3621200","4163300","22102000","82369500","104471500"
"2150","67746","14060080","01- Annual","2017-01-01T00:00:00","542100","3810400","4352500","22102000","79687100","101789100"
"2151","67751","17011059","01- Annual","2014-01-01T00:00:00","797800","1244400","2042200","10121600","12582300","22703900"
"2152","67751","17011059","","2012-01-01T00:00:00","918200","0","918200","8602400","0","8602400"
"2153","67751","17011059","01- Annual","2013-01-01T00:00:00","797800","0","797800","10121600","1514000","11635600"
"2154","67752","17011060","01- Annual","2013-01-01T00:00:00","77800","0","77800","987600","147800","1135400"
"2155","67752","17011060","","2012-01-01T00:00:00","89600","0","89600","839300","0","839300"
"2156","67752","17011060","01- Annual","2014-01-01T00:00:00","77800","121500","199300","987600","1228300","2215900"
"2157","67753","17011061","01- Annual","2014-01-01T00:00:00","64100","99900","164000","813200","1010600","1823800"
"2158","67753","17011061","","2012-01-01T00:00:00","73800","0","73800","691100","0","691100"
"2159","67753","17011061","01- Annual","2013-01-01T00:00:00","64100","0","64100","813200","121600","934800"
"2160","67757","17011062","01- Annual","2013-01-01T00:00:00","1824600","0","1824600","9139800","1852200","10992000"
"2161","67757","17011062","","2012-01-01T00:00:00","1824600","0","1824600","9982500","0","9982500"
"2162","67757","17011062","01- Annual","2014-01-01T00:00:00","1824600","1422100","3246700","9139800","8058500","17198300"
"2163","67758","17011063","01- Annual","2014-01-01T00:00:00","63700","49700","113400","319300","281500","600800"
"2164","67758","17011063","","2012-01-01T00:00:00","63700","0","63700","348800","0","348800"
"2165","67758","17011063","01- Annual","2013-01-01T00:00:00","63700","0","63700","319300","64700","384000"
"2166","67759","17011064","01- Annual","2013-01-01T00:00:00","82000","0","82000","410800","83300","494100"
"2167","67759","17011064","","2012-01-01T00:00:00","82000","0","82000","448700","0","448700"
"2168","67759","17011064","01- Annual","2014-01-01T00:00:00","82000","64000","146000","410800","362400","773200"
"2169","67813","15070005","01- Annual","2014-01-01T00:00:00","1237600","249600","1487200","0","0","0"
"2170","67813","15070005","","2012-01-01T00:00:00","1237600","249600","1487200","0","0","0"
"2171","67813","15070005","01- Annual","2013-01-01T00:00:00","1237600","249600","1487200","0","0","0"
"2172","67814","15070006","01- Annual","2013-01-01T00:00:00","0","0","0","8120000","13731100","21851100"
"2173","67814","15070006","","2012-01-01T00:00:00","0","0","0","8120000","13278300","21398300"
"2174","67814","15070006","01- Annual","2014-01-01T00:00:00","0","0","0","8120000","14478200","22598200"
"2175","67814","15070006","03- Board of Equalization","2013-10-16T00:00:00","0","0","0","8120000","10570600","18690600"
"2176","67836","31025131","","2012-01-01T00:00:00","0","0","0","0","2652300","2652300"
"2177","67836","31025131","01- Annual","2013-01-01T00:00:00","0","102500","102500","0","2549800","2549800"
"2178","67837","18038025","01- Annual","2013-01-01T00:00:00","1674800","7707800","9382600","11280000","49461700","60741700"
"2179","67837","18038025","01- Annual","2014-01-01T00:00:00","1674800","7406400","9081200","11280000","54952600","66232600"
"2180","67837","18038025","05- Review","2014-09-03T00:00:00","1674800","6387000","8061800","11280000","49863600","61143600"
"2181","67837","18038025","01- Annual","2016-01-01T00:00:00","1674800","7594000","9268800","13160000","60543800","73703800"
"2182","67837","18038025","03- Board of Equalization","2015-08-21T00:00:00","1674800","8798200","10473000","12408000","50430500","62838500"
"2183","67837","18038025","01- Annual","2015-01-01T00:00:00","1674800","8798200","10473000","12408000","53065600","65473600"
"2184","67837","18038025","03- Board of Equalization","2015-08-21T00:00:00","1674800","6163100","7837900","12408000","53065600","65473600"
"2185","67837","18038025","01- Annual","2017-01-01T00:00:00","1674800","10981300","12656100","13912000","61947600","75859600"
"2186","67837","18038025","01- Annual","2018-01-01T00:00:00","1674800","11047500","12722300","11280000","64753200","76033200"
"2187","67837","18038025","03- Board of Equalization","2017-08-31T00:00:00","1674800","10438900","12113700","13912000","58697100","72609100"
"2188","67838","17011065","01- Annual","2015-01-01T00:00:00","198900","0","198900","0","0","0"
"2189","67838","17011065","01- Annual","2016-01-01T00:00:00","208600","0","208600","0","0","0"
"2190","67838","17011065","01- Annual","2014-01-01T00:00:00","0","179600","179600","0","0","0"
"2191","67838","17011065","01- Annual","2013-01-01T00:00:00","179600","0","179600","0","0","0"
"2192","67849","14044261","01- Annual","2013-01-01T00:00:00","343800","1064700","1408500","18060000","69090900","87150900"
"2193","67849","14044261","01- Annual","2014-01-01T00:00:00","343800","1177300","1521100","18060000","76061400","94121400"
"2194","67849","14044261","05- Review","2016-04-27T00:00:00","343800","2666700","3010500","20898000","77439700","98337700"
"2195","67849","14044261","01- Annual","2016-01-01T00:00:00","343800","2666700","3010500","19866000","78573300","98439300"
"2196","67849","14044261","01- Annual","2015-01-01T00:00:00","343800","1684400","2028200","19866000","80247400","100113400"
"2197","67849","14044261","03- Board of Equalization","2017-10-31T00:00:00","343800","2141800","2485600","20210000","81071000","101281000"
"2198","67849","14044261","01- Annual","2018-01-01T00:00:00","343800","2313100","2656900","22188000","85114600","107302600"
"2199","67849","14044261","01- Annual","2017-01-01T00:00:00","343800","2682000","3025800","22188000","81790400","103978400"
"2200","67863","15058016","01- Annual","2018-01-01T00:00:00","189400","1301700","1491100","18834000","75200000","94034000"
"2201","67863","15058016","05- Review","2015-09-03T00:00:00","189400","1349900","1539300","16863000","69308100","86171100"
"2202","67863","15058016","01- Annual","2016-01-01T00:00:00","189400","1387700","1577100","17739000","74523000","92262000"
"2203","67863","15058016","03- Board of Equalization","2016-09-19T00:00:00","189400","1387700","1577100","17739000","74482800","92221800"
"2204","67863","15058016","01- Annual","2017-01-01T00:00:00","189400","1551800","1741200","18834000","74963400","93797400"
"2205","67863","15058016","01- Annual","2014-01-01T00:00:00","189400","1379700","1569100","15330000","73784600","89114600"
"2206","67863","15058016","01- Annual","2015-01-01T00:00:00","189400","1349900","1539300","16863000","69348600","86211600"
"2207","67863","15058016","01- Annual","2013-01-01T00:00:00","189400","1299800","1489200","15330000","65410600","80740600"
"2208","67912","26001112","05- Review","2016-05-20T00:00:00","772200","4472900","5245100","17990000","53582900","71572900"
"2209","67912","26001112","01- Annual","2016-01-01T00:00:00","772200","4472900","5245100","17990000","56785800","74775800"
"2210","67912","26001112","01- Annual","2018-01-01T00:00:00","772200","5098600","5870800","15420000","70066700","85486700"
"2211","67912","26001112","01- Annual","2017-01-01T00:00:00","772200","5181500","5953700","19018000","62224200","81242200"
"2212","67946","14035026","01- Annual","2013-01-01T00:00:00","27300","0","27300","1328700","0","1328700"
"2213","67946","14035026","01- Annual","2013-01-01T00:00:00","27300","0","27300","1328700","0","1328700"
"2214","67947","14035027","01- Annual","2013-01-01T00:00:00","3400","0","3400","167000","0","167000"
"2215","67947","14035027","01- Annual","2013-01-01T00:00:00","3400","0","3400","167000","0","167000"
"2216","67981","35003439","01- Annual","2013-01-01T00:00:00","844900","0","844900","24778800","0","24778800"
"2217","67981","35003439","05- Review","2014-09-15T00:00:00","981000","0","981000","28770000","0","28770000"
"2218","67981","35003439","01- Annual","2014-01-01T00:00:00","844900","0","844900","24778800","0","24778800"
"2219","67982","35003035","01- Annual","2014-01-01T00:00:00","136100","0","136100","3991200","0","3991200"
"2220","67982","35003035","05- Review","2014-09-15T00:00:00","136100","0","136100","3991200","0","3991200"
"2221","67982","35003035","05- Review","2014-09-08T00:00:00","233500","0","233500","4715500","0","4715500"
"2222","67982","35003035","01- Annual","2013-01-01T00:00:00","136100","0","136100","3991200","0","3991200"
"2223","68003","17005012","01- Annual","2017-01-01T00:00:00","758100","3888700","4646800","40764000","162861600","203625600"
"2224","68003","17005012","01- Annual","2018-01-01T00:00:00","758100","3754100","4512200","40764000","172403300","213167300"
"2225","68003","17005012","03- Board of Equalization","2017-10-09T00:00:00","758100","2858300","3616400","40764000","155743500","196507500"
"2226","68006","35011010","01- Annual","2018-01-01T00:00:00","159500","0","159500","30824600","0","30824600"
"2227","68006","35011010","01- Annual","2017-01-01T00:00:00","159500","3264700","3424200","30824600","115762700","146587300"
"2228","68006","35011010","05- Review","2018-03-07T00:00:00","159500","3269000","3428500","30824600","117562600","148387200"
"2229","68006","35011010","01- Annual","2014-01-01T00:00:00","405800","721500","1127300","32060000","128554300","160614300"
"2230","68006","35011010","05- Review","2014-08-07T00:00:00","405800","703000","1108800","32060000","124042900","156102900"
"2231","68006","35011010","01- Annual","2016-01-01T00:00:00","405800","1193000","1598800","37087400","119387300","156474700"
"2232","68006","35011010","01- Annual","2015-01-01T00:00:00","405800","1216300","1622100","35266000","121005600","156271600"
"2233","68006","35011010","01- Annual","2013-01-01T00:00:00","405800","696100","1101900","32060000","114126000","146186000"
"2234","68006","35011010","01- Annual","2013-01-01T00:00:00","405800","696100","1101900","63840000","227252100","291092100"
"2235","68007","35011011","01- Annual","2013-01-01T00:00:00","405800","696100","1101900","63840000","227252100","291092100"
"2236","68007","35011011","01- Annual","2013-01-01T00:00:00","0","0","0","31780000","113126100","144906100"
"2237","68007","35011011","01- Annual","2015-01-01T00:00:00","0","0","0","34958000","119945500","154903500"
"2238","68007","35011011","01- Annual","2016-01-01T00:00:00","0","0","0","36784600","118341200","155125800"
"2239","68007","35011011","05- Review","2014-08-07T00:00:00","0","0","0","31780000","122956200","154736200"
"2240","68007","35011011","01- Annual","2014-01-01T00:00:00","0","0","0","31780000","127428000","159208000"
"2241","68007","35011011","05- Review","2018-03-07T00:00:00","246300","0","246300","47607400","116532600","164140000"
"2242","68007","35011011","01- Annual","2017-01-01T00:00:00","246300","0","246300","47607400","114748500","162355900"
"2243","68007","35011011","01- Annual","2018-01-01T00:00:00","246300","0","246300","47607400","0","47607400"
"2244","68034","14035028","01- Annual","2018-01-01T00:00:00","0","0","0","100","0","100"
"2245","68034","14035028","01- Annual","2017-01-01T00:00:00","0","0","0","100","0","100"
"2246","68034","14035028","01- Annual","2014-01-01T00:00:00","0","0","0","100","0","100"
"2247","68034","14035028","01- Annual","2016-01-01T00:00:00","0","0","0","100","0","100"
"2248","68034","14035028","01- Annual","2015-01-01T00:00:00","0","0","0","100","0","100"
"2249","68103","05056127","01- Annual","2018-01-01T00:00:00","0","0","0","0","0","0"
"2250","68105","22011272","01- Annual","2018-01-01T00:00:00","333700","896500","1230200","4980000","8076000","13056000"
"2251","68105","22011272","01- Annual","2017-01-01T00:00:00","333700","1595800","1929500","6142000","6034900","12176900"
"2252","68105","22011272","01- Annual","2016-01-01T00:00:00","333700","265500","599200","5810000","7663400","13473400"
"2253","68107","14035029","01- Annual","2016-01-01T00:00:00","768900","4094400","4863300","40500000","136696100","177196100"
"2254","68107","14035029","01- Annual","2017-01-01T00:00:00","768900","4236600","5005500","43000000","148345800","191345800"
"2255","68107","14035029","01- Annual","2018-01-01T00:00:00","768900","4176700","4945600","43000000","157558500","200558500"
"2256","68151","15078025","01- Annual","2018-01-01T00:00:00","1097900","6069500","7167400","13330000","69971700","83301700"
"2257","68151","15078025","03- Board of Equalization","2017-10-31T00:00:00","1097900","5008200","6106100","13330000","66578400","79908400"
"2258","68151","15078025","01- Annual","2017-01-01T00:00:00","1097900","6049700","7147600","13330000","66578400","79908400"
"2259","68151","15078025","01- Annual","2016-01-01T00:00:00","1097900","5846600","6944500","12555000","50157400","62712400"
"2260","68151","15078025","01- Annual","2015-01-01T00:00:00","1097900","5567400","6665300","11935000","48875600","60810600"
"2261","68362","35003022","05- Review","2016-05-16T00:00:00","2453500","3070200","5523700","56618900","79852100","136471000"
"2262","68362","35003022","05- Review","2016-04-05T00:00:00","2157700","2640400","4798100","48692300","68672800","117365100"
"2263","68363","35003023","05- Review","2016-05-16T00:00:00","0","0","0","100","0","100"
"2264","68363","35003023","05- Review","2016-04-05T00:00:00","295800","429800","725600","7926700","11179300","19106000"
"2265","68363","35003023","01- Annual","2017-01-01T00:00:00","74800","0","74800","6397900","0","6397900"
"2266","68363","35003023","01- Annual","2018-01-01T00:00:00","74800","0","74800","6397900","0","6397900"
"2267","68520","17011068","01- Annual","2018-01-01T00:00:00","1053800","9970800","11024600","16426000","72199600","88625600"
"2268","68520","17011068","01- Annual","2017-01-01T00:00:00","1053800","7145100","8198900","16426000","68225500","84651500"
"2269","68520","17011068","03- Board of Equalization","2017-10-31T00:00:00","1053800","6042600","7096400","16426000","68225500","84651500"
"2270","68520","17011068","01- Annual","2016-01-01T00:00:00","1053800","6099800","7153600","15471000","63717400","79188400"
"2271","68520","17011068","01- Annual","2015-01-01T00:00:00","1053800","6326900","7380700","14707000","58537500","73244500"
"2272","68520","17011068","05- Review","2015-09-04T00:00:00","1053800","6326900","7380700","14707000","55821500","70528500"
"2273","68641","17011069","01- Annual","2015-01-01T00:00:00","2081100","9642800","11723900","14707000","51077600","65784600"
"2274","68773","20012393","01- Annual","2015-01-01T00:00:00","132200","793600","925800","12551000","38529900","51080900"
"2275","68773","20012393","03- Board of Equalization","2015-09-28T00:00:00","132200","712321","844521","12551000","34045379","46596379"
"2276","68773","20012393","01- Annual","2016-01-01T00:00:00","132200","855800","988000","13203000","40044200","53247200"
"2277","68773","20012393","05- Review","2016-05-10T00:00:00","132200","855800","988000","13203000","37695500","50898500"
"2278","68773","20012393","01- Annual","2017-01-01T00:00:00","132200","1021500","1153700","14018000","40451900","54469900"
"2279","68773","20012393","01- Annual","2018-01-01T00:00:00","132200","902000","1034200","14018000","41880800","55898800"
"2280","69223","15005010","05- Review","2018-03-07T00:00:00","449600","4453200","4902800","8220500","14158600","22379100"
"2281","69223","15005010","05- Review","2018-04-24T00:00:00","449600","3932800","4382400","8220500","13521900","21742400"
"2282","69223","15005010","01- Annual","2017-01-01T00:00:00","449600","4515300","4964900","10138600","13071700","23210300"
"2283","69223","15005010","03- Board of Equalization","2017-09-30T00:00:00","449600","4515300","4964900","10138600","12509400","22648000"
"2284","69223","15005010","01- Annual","2018-01-01T00:00:00","449600","4515300","4964900","8220500","13071700","21292200"
"2285","69271","15003009","01- Annual","2018-01-01T00:00:00","213300","0","213300","3899500","49174600","53074100"
"2286","69271","15003009","03- Board of Equalization","2017-09-30T00:00:00","213300","0","213300","4809400","47059000","51868400"
"2287","69271","15003009","01- Annual","2017-01-01T00:00:00","213300","0","213300","4809400","49174600","53984000"
"2288","69271","15003009","05- Review","2018-04-24T00:00:00","213300","0","213300","3899500","50868100","54767600"
"2289","69271","15003009","05- Review","2018-03-07T00:00:00","213300","0","213300","3899500","53263200","57162700"
"2290","69463","35003840","01- Annual","2017-01-01T00:00:00","2453500","14745300","17198800","60114000","206167900","266281900"
"2291","69463","35003840","01- Annual","2018-01-01T00:00:00","2453500","12905200","15358700","60114000","252858500","312972500"
"2292","69508","18004071","01- Annual","2018-01-01T00:00:00","376300","0","376300","13169700","0","13169700"
"2293","69508","18004071","01- Annual","2017-01-01T00:00:00","97300","772600","869900","3405600","11284000","14689600"
"2294","69646","14032005","01- Annual","2018-01-01T00:00:00","355000","2030700","2385700","22790000","97203800","119993800"
"2295","69725","34027033","01- Annual","2018-01-01T00:00:00","403700","0","403700","35432000","92452900","127884900"
"2296","69726","34027034","01- Annual","2018-01-01T00:00:00","143700","0","143700","17630000","0","17630000"
